"a" = (/turf/closed/wall/mineral/wood/nonmetal,/area/space)
"c" = (/obj/effect/mob_spawn/corpse/human,/turf/open/floor/carpet/red,/area/space)
"f" = (/turf/closed/wall/mineral/iron{name = "rough stone wall"; desc = "A wall with rough cobblestones forming a wall"},/area/space)
"i" = (/obj/effect/mapping_helpers/airlock/cutaiwire,/obj/machinery/door/airlock/cult/friendly{name = "Captains Quarters"},/turf/open/floor/carpet/red,/area/space)
"n" = (/obj/effect/decal/cleanable/blood,/obj/machinery/light/small/directional/north,/turf/open/floor/stone,/area/space)
"o" = (/turf/open/floor/iron/solarpanel/airless,/area/space)
"q" = (/obj/structure/table/wood/fancy/black,/obj/item/vorpalscythe{name = "Headtaker"; force = 25; bonus_force_multiplier = 4; block_chance = 10; wound_bonus = 20; bare_wound_bonus = 25},/turf/open/floor/carpet/red,/area/space)
"r" = (/obj/effect/decal/cleanable/blood,/turf/open/floor/stone,/area/space)
"s" = (/obj/machinery/door/airlock/vault{color = "#825427"; name = "Ship Armoury"},/obj/effect/mapping_helpers/airlock/cutaiwire,/turf/open/floor/wood/airless,/area/space)
"w" = (/obj/effect/decal/cleanable/blood,/obj/item/kirbyplants/random/dead,/turf/open/floor/stone,/area/space)
"y" = (/turf/open/floor/carpet/red,/area/space)
"B" = (/obj/structure/closet/cabinet{name = "The red captains cabinet"},/obj/item/clothing/shoes/pirate/armored,/obj/item/clothing/suit/hooded/cloak/goliath{name = "red captains cloak"},/obj/item/clothing/under/syndicate/bloodred{name = "blood-red suit"},/obj/item/clothing/suit/hooded/berserker{pressure_resistance = 5; min_cold_protection_temperature = 0; name = "red kings armor"; desc = "Voices of all those claimed by their fury echo through the armour."; hoodtype = /obj/item/clothing/head/costume/pirate/armored; icon_state = "hgpirate"; icon = 'icons/obj/clothing/suits/costume.dmi'; worn_icon = 'icons/mob/clothing/suits/costume.dmi'},/turf/open/floor/stone,/area/space)
"D" = (/obj/effect/decal/cleanable/blood,/turf/open/floor/carpet/red,/area/space)
"E" = (/obj/effect/mob_spawn/corpse/human,/turf/open/floor/stone,/area/space)
"F" = (/obj/structure/closet/crate/coffin{pixel_y = 6; name = "The red captains coffin"},/obj/item/flashlight/flare/candle/infinite{pixel_x = -10; pixel_y = -9},/obj/item/flashlight/flare/candle/infinite{pixel_x = 14; pixel_y = -8},/obj/item/flashlight/flare/candle/infinite{pixel_x = -12; pixel_y = 15},/obj/item/flashlight/flare/candle/infinite{pixel_x = 10; pixel_y = 17},/turf/open/floor/carpet/red,/area/space)
"J" = (/obj/structure/lattice/catwalk,/turf/closed/wall/mineral/wood/nonmetal,/area/space)
"L" = (/obj/item/kirbyplants/random/dead,/turf/open/floor/stone,/area/space)
"Q" = (/turf/open/floor/wood/airless,/area/space)
"R" = (/obj/structure/table/wood/fancy/black,/obj/item/gun/energy/beam_rifle{lefthand_file = icons/mob/inhands/weapons/melee_lefthand.dmi; righthand_file = icons/mob/inhands/weapons/melee_righthand.dmi; inhand_icon_state = powerfist; icon = 'icons/obj/device_syndie.dmi'; icon_state = "powerfist"; pixel_y = 5; pixel_x = 3; color = #669900; name = "Hand of the red captain"; desc = "A weapon of devestating potential looted from an experimental terran lab.},/obj/item/necromantic_stone,/turf/open/floor/carpet/red,/area/space)
"T" = (/obj/effect/mapping_helpers/airlock/cutaiwire,/obj/machinery/door/airlock/cult/friendly{name = "Captains Quarters"},/turf/open/floor/carpet/red/airless,/area/space)
"U" = (/turf/open/space/basic,/area/space)
"V" = (/obj/structure/lattice/catwalk,/turf/open/space/basic,/area/space)
"W" = (/obj/structure/closet/crate/freezer/blood,/turf/open/floor/stone,/area/space)
"Y" = (/obj/machinery/door/airlock/vault{color = "#825427"; name = "Ye Olde Strong Door"},/obj/effect/mapping_helpers/airlock/cutaiwire,/turf/open/floor/wood/airless,/area/space)
"Z" = (/turf/open/floor/stone,/area/space)

(1,1,1) = {"
UUUUUUUUUUUUUUUUUUUUUUUUUUUUUUUUUUUUUUUUUUUUUUUUUUUUUUUUUUUUUUUUUUUUUUUUUUU
UUUUUUUUUUUUUUUUUUUUUUUUUUUUUUUUUUUUUUUUUUUUUUUUUUUUUUUUUUUUUUUUUUUUUUUUUUU
UUUUUUUUUUUUUUUUUUUUUUUUUUUUUUUUUUUUUUUUUUUUUUUUUUUUUUUUUUUUUUUUUUUUUUUUUUU
UUUUUUUUUUUUUUUUUUUUUUUUUUUUUUUUUUUUUUUUUUUUUUUUUUUUUUUUUUUUUUUUUUUUUUUUUUU
UUUUUUUUUUUUUUUUUUUUUUUUUUUUUUUUUUUUUUUUUUUUUUUUUUUUUUUUUUUUUUUUUUUUUUUUUUU
UUUUUUUUUUUUUUUUUUUUUUUUUUUUUUUUUUUUUUUUUUUUUUUUUUUUUUUUUUUUUUUUUUUUUUUUUUU
UUUUUUUUUUUUUUUUUUUUUUUUUUUUUUUUUUUUUUUUUUUUUUUUUUUUUUUUUUUUUUUUUUUUUUUUUUU
UUUUUUUUUUUUUUUUUUUUUUUUUUUUUUUUUUUUUUUUUUUUUUUUUUUUUUUUUUUUUUUUUUUUUUUUUUU
UUUUUUUUUUUUUUUUUUUUUUUUUUUUUUUUUUUUUUUUUUUUUUUUUUUUUUUUUUUUUUUUUUUUUUUUUUU
UUUUUUUUUUUUUUUUUUUUUUUUUUUUUUUUUUUUUUUUUUUUUUUUUUUUUUUUUUUUUUUUUUUUUUUUUUU
UUUUUUUUUUUUUUUUUUUoUUUUUUUUUUUUUUUoUUUUUUUUUUUUUUUUUUUUUUUUUUUUUUUUUUUUUUU
UUUUUUUUUUUUUUUUUUoVoUUUUUUUUUUUUUoVoUUUUUUUUUUUUUUUUUUUUUUUUUUUUUUUUUUUUUU
UUUUUUUUUUUUUUUUUUoVoUUUUUUUUUUUUUoVoUUUUUUUUUUUUUUUUUUUUUUUUUUUUUUUUUUUUUU
UUUUUUUUUUUUUUUUUUoVooUUUUUUUUUUUUoVooUUUUUUUUUUUUUUUUUUUUUUUUUUUUUUUUUUUUU
UUUUUUUUUUUUUUUUUUoVVVoUUUUUUUUUUUoVVVoUUUUUUUUUUUUUUUUUUUUUUUUUUUUUUUUUUUU
UUUUUUUUUUUUUUUUUUoVVoUUUUUUUUUUUUoVVoUUUUUUUUUUUUUUUUUUUUUUUUUUUUUUUUUUUUU
UUUUUUUUUUUUUUUUUUoVoUUUUUUUUUUUUUoVoUUUUUUUUUUUUUUUUUUUUUUUUUUUUUUUUUUUUUU
UUUUUUUaaaaUUUUUUUoVoUUUUUUUUUUUUUoVoUUUUUUUUUUUUUUUUUUUUUUUUUUUUUUUUUUUUUU
UUUUUUaaQQaaUUUUUVVVoUUUUUUUUUUUUVVVoUUUUUUUUUUUUUUUUUUUUUUUUUUUUUUUUUUUUUU
UUUUUaaQQQQaaaaaaaaJaaaaaaaaaaaaaaaaaaaaaaaaaaUUUUUUUUUUUUUUUUUUUUUUUUUUUUU
UUUUUaQQQQQQQaQQQQQQQQQQQQQQQQQQQQQQQQQQQQQQaaaUUUUUUUUUUUUUUUUUUUUUUUUUUUU
UUUUaaQQQQQQQaaQQQQQQQQQQQQQQQQQQQQQQQQQQQQQQaaaUUUUUUUUUUUUUUUUUUUUUUUUUUU
UUUUaQQQQQQQQQaQQQQQQQQQQQQQQQQQQQQQQQQQQQQQQQQaaaUUUUUUUUUUUUUUUUUUUUUUUUU
UUUaaaaaaaasaaaQQQQQQQQQQQQQQQQQQQQQQQQQQQQQQQQQQaaaUUUUUUUUUUUUUUUUUUUUUUU
UUUaQQQQQQQQQQaQQQQQQQQQQQQQQQQQQQQQQQQQQQQQQQQQQQQaaaUUUUUUUUUUUUUUUUUUUUU
UUUaQQQQQQQQQQYQQQQQQQQQQQQQQQQQQQQQQQQQQQQQQQQQQQQQQaaaUUUUUUUUUUUUUUUUUUU
UUUaQQQQQQQQQQaQQQQQQQQQQQQQQQQQQQQQQQQQQQQQQQQQQQQQQaaaUUUUUUUUUUUUUUUUUUU
UUUaQQQQQQQQQQaQQQQQQQQQQQQQQQQQQQQQQQQQQQQQQQQQQQQaaaUUUUUUUUUUUUUUUUUUUUU
UUUaafffiTffffaQQQQQQQQQQQQQQQQQQQQQQQQQQQQQQQQQQaaaUUUUUUUUUUUUUUUUUUUUUUU
UUUUaWLnDynZLWaQQQQQQQQQQQQQQQQQQQQQQQQQQQQQQQQaaaUUUUUUUUUUUUUUUUUUUUUUUUU
UUUUaarEyyDFZaaQQQQQQQQQQQQQQQQQQQQQQQQQQQQQQaaaUUUUUUUUUUUUUUUUUUUUUUUUUUU
UUUUUaLZDcZwBaQQQQQQQQQQQQQQQQQQQQQQQQQQQQQQaaaUUUUUUUUUUUUUUUUUUUUUUUUUUUU
UUUUUaaLyyLaaaaaaaaaaaaaaaaaaaaaaaaaaaaaaaaaaaUUUUUUUUUUUUUUUUUUUUUUUUUUUUU
UUUUUUaaRqaaUUUUUVVVoUUUUUUUUUUUUVVVoUUUUUUUUUUUUUUUUUUUUUUUUUUUUUUUUUUUUUU
UUUUUUUaaaaUUUUUUUoVoUUUUUUUUUUUUUoVoUUUUUUUUUUUUUUUUUUUUUUUUUUUUUUUUUUUUUU
UUUUUUUUUUUUUUUUUUoVoUUUUUUUUUUUUUoVoUUUUUUUUUUUUUUUUUUUUUUUUUUUUUUUUUUUUUU
UUUUUUUUUUUUUUUUUUoVoUUUUUUUUUUUUUoVoUUUUUUUUUUUUUUUUUUUUUUUUUUUUUUUUUUUUUU
UUUUUUUUUUUUUUUUUUoVVoUUUUUUUUUUUUoVVoUUUUUUUUUUUUUUUUUUUUUUUUUUUUUUUUUUUUU
UUUUUUUUUUUUUUUUUUoVVVoUUUUUUUUUUUoVVVoUUUUUUUUUUUUUUUUUUUUUUUUUUUUUUUUUUUU
UUUUUUUUUUUUUUUUUUoVooUUUUUUUUUUUUoVooUUUUUUUUUUUUUUUUUUUUUUUUUUUUUUUUUUUUU
UUUUUUUUUUUUUUUUUUoVoUUUUUUUUUUUUUoVoUUUUUUUUUUUUUUUUUUUUUUUUUUUUUUUUUUUUUU
UUUUUUUUUUUUUUUUUUUoUUUUUUUUUUUUUUUoUUUUUUUUUUUUUUUUUUUUUUUUUUUUUUUUUUUUUUU
UUUUUUUUUUUUUUUUUUUUUUUUUUUUUUUUUUUUUUUUUUUUUUUUUUUUUUUUUUUUUUUUUUUUUUUUUUU
UUUUUUUUUUUUUUUUUUUUUUUUUUUUUUUUUUUUUUUUUUUUUUUUUUUUUUUUUUUUUUUUUUUUUUUUUUU
UUUUUUUUUUUUUUUUUUUUUUUUUUUUUUUUUUUUUUUUUUUUUUUUUUUUUUUUUUUUUUUUUUUUUUUUUUU
UUUUUUUUUUUUUUUUUUUUUUUUUUUUUUUUUUUUUUUUUUUUUUUUUUUUUUUUUUUUUUUUUUUUUUUUUUU
UUUUUUUUUUUUUUUUUUUUUUUUUUUUUUUUUUUUUUUUUUUUUUUUUUUUUUUUUUUUUUUUUUUUUUUUUUU
UUUUUUUUUUUUUUUUUUUUUUUUUUUUUUUUUUUUUUUUUUUUUUUUUUUUUUUUUUUUUUUUUUUUUUUUUUU
UUUUUUUUUUUUUUUUUUUUUUUUUUUUUUUUUUUUUUUUUUUUUUUUUUUUUUUUUUUUUUUUUUUUUUUUUUU
UUUUUUUUUUUUUUUUUUUUUUUUUUUUUUUUUUUUUUUUUUUUUUUUUUUUUUUUUUUUUUUUUUUUUUUUUUU
"}
