"a" = (/turf/open/space/basic,/area/space)
"b" = (/turf/open/floor/stone,/area/space)
"d" = (/obj/effect/mapping_helpers/airlock/cutaiwire,/obj/machinery/door/airlock/cult/friendly{name = "Captains Quarters"},/turf/open/floor/carpet/red/airless,/area/space)
"j" = (/turf/open/floor/iron/solarpanel/airless,/area/space)
"o" = (/turf/open/floor/wood/airless,/area/space)
"p" = (/turf/closed/wall/mineral/wood/nonmetal,/area/space)
"r" = (/obj/structure/lattice/catwalk,/turf/closed/wall/mineral/wood/nonmetal,/area/space)
"t" = (/obj/structure/table/wood/fancy/black,/obj/item/gun/energy/beam_rifle{lefthand_file = icons/mob/inhands/weapons/melee_lefthand.dmi; righthand_file = icons/mob/inhands/weapons/melee_righthand.dmi; inhand_icon_state = powerfist; icon = 'icons/obj/device_syndie.dmi'; icon_state = "powerfist"; pixel_y = 5; pixel_x = 3; color = #669900; name = "Hand of the red captain"; desc = "A weapon of devestating potential looted from an experimental terran lab.},/turf/open/floor/carpet/red,/area/space)
"u" = (/obj/structure/lattice/catwalk,/turf/open/space/basic,/area/space)
"x" = (/obj/structure/closet/cabinet{name = "The red captains cabinet"},/obj/item/clothing/shoes/pirate/armored,/obj/item/clothing/suit/hooded/cloak/goliath{name = "red captains cloak"},/obj/item/clothing/under/syndicate/bloodred{name = "blood-red suit"},/obj/item/clothing/suit/hooded/berserker{pressure_resistance = 5; min_cold_protection_temperature = 0; name = "red kings armor"; desc = "Voices of all those claimed by their fury echo through the armour."; hoodtype = /obj/item/clothing/head/costume/pirate/armored; icon_state = "hgpirate"; icon = 'icons/obj/clothing/suits/costume.dmi'; worn_icon = 'icons/mob/clothing/suits/costume.dmi'},/turf/open/floor/stone,/area/space)
"C" = (/obj/structure/closet/crate/coffin{pixel_y = 6; name = "The red captains coffin"},/obj/item/flashlight/flare/candle/infinite{pixel_x = -10; pixel_y = -9},/obj/item/flashlight/flare/candle/infinite{pixel_x = 14; pixel_y = -8},/obj/item/flashlight/flare/candle/infinite{pixel_x = -12; pixel_y = 15},/obj/item/flashlight/flare/candle/infinite{pixel_x = 10; pixel_y = 17},/turf/open/floor/carpet/red,/area/space)
"D" = (/turf/open/floor/carpet/red,/area/space)
"I" = (/obj/structure/table/wood/fancy/black,/obj/item/vorpalscythe{name = "Headtaker"; force = 30; bonus_force_multiplier = 4; block_chance = 10},/turf/open/floor/carpet/red,/area/space)
"J" = (/turf/closed/wall/mineral/iron{name = "rough stone wall"; desc = "A wall with rough cobblestones forming a wall"},/area/space)
"P" = (/obj/effect/mapping_helpers/airlock/cutaiwire,/obj/machinery/door/airlock/cult/friendly{name = "Captains Quarters"},/turf/open/floor/carpet/red,/area/space)
"R" = (/obj/machinery/door/airlock/vault{color = "#825427"; name = "Ye Olde Strong Door"},/obj/effect/mapping_helpers/airlock/cutaiwire,/turf/open/floor/wood/airless,/area/space)

(1,1,1) = {"
aaaaaaaaaaaaaaaaaaaaaaaaaaaaaaaaaaaaaaaaaaaaaaaaaaaaaaaaaaaaaaaaaaaaaaaaaaa
aaaaaaaaaaaaaaaaaaaaaaaaaaaaaaaaaaaaaaaaaaaaaaaaaaaaaaaaaaaaaaaaaaaaaaaaaaa
aaaaaaaaaaaaaaaaaaaaaaaaaaaaaaaaaaaaaaaaaaaaaaaaaaaaaaaaaaaaaaaaaaaaaaaaaaa
aaaaaaaaaaaaaaaaaaaaaaaaaaaaaaaaaaaaaaaaaaaaaaaaaaaaaaaaaaaaaaaaaaaaaaaaaaa
aaaaaaaaaaaaaaaaaaaaaaaaaaaaaaaaaaaaaaaaaaaaaaaaaaaaaaaaaaaaaaaaaaaaaaaaaaa
aaaaaaaaaaaaaaaaaaaaaaaaaaaaaaaaaaaaaaaaaaaaaaaaaaaaaaaaaaaaaaaaaaaaaaaaaaa
aaaaaaaaaaaaaaaaaaaaaaaaaaaaaaaaaaaaaaaaaaaaaaaaaaaaaaaaaaaaaaaaaaaaaaaaaaa
aaaaaaaaaaaaaaaaaaaaaaaaaaaaaaaaaaaaaaaaaaaaaaaaaaaaaaaaaaaaaaaaaaaaaaaaaaa
aaaaaaaaaaaaaaaaaaaaaaaaaaaaaaaaaaaaaaaaaaaaaaaaaaaaaaaaaaaaaaaaaaaaaaaaaaa
aaaaaaaaaaaaaaaaaaaaaaaaaaaaaaaaaaaaaaaaaaaaaaaaaaaaaaaaaaaaaaaaaaaaaaaaaaa
aaaaaaaaaaaaaaaaaaajaaaaaaaaaaaaaaajaaaaaaaaaaaaaaaaaaaaaaaaaaaaaaaaaaaaaaa
aaaaaaaaaaaaaaaaaajujaaaaaaaaaaaaajujaaaaaaaaaaaaaaaaaaaaaaaaaaaaaaaaaaaaaa
aaaaaaaaaaaaaaaaaajujaaaaaaaaaaaaajujaaaaaaaaaaaaaaaaaaaaaaaaaaaaaaaaaaaaaa
aaaaaaaaaaaaaaaaaajujjaaaaaaaaaaaajujjaaaaaaaaaaaaaaaaaaaaaaaaaaaaaaaaaaaaa
aaaaaaaaaaaaaaaaaajuuujaaaaaaaaaaajuuujaaaaaaaaaaaaaaaaaaaaaaaaaaaaaaaaaaaa
aaaaaaaaaaaaaaaaaajuujaaaaaaaaaaaajuujaaaaaaaaaaaaaaaaaaaaaaaaaaaaaaaaaaaaa
aaaaaaaaaaaaaaaaaajujaaaaaaaaaaaaajujaaaaaaaaaaaaaaaaaaaaaaaaaaaaaaaaaaaaaa
aaaaaaappppaaaaaaajujaaaaaaaaaaaaajujaaaaaaaaaaaaaaaaaaaaaaaaaaaaaaaaaaaaaa
aaaaaappooppaaaaauuujaaaaaaaaaaaauuujaaaaaaaaaaaaaaaaaaaaaaaaaaaaaaaaaaaaaa
aaaaappoooopppppppprppppppppppppppppppppppppppaaaaaaaaaaaaaaaaaaaaaaaaaaaaa
aaaaapooooooopoooooooooooooooooooooooooooooopppaaaaaaaaaaaaaaaaaaaaaaaaaaaa
aaaappoooooooppoooooooooooooooooooooooooooooopppaaaaaaaaaaaaaaaaaaaaaaaaaaa
aaaapooooooooopoooooooooooooooooooooooooooooooopppaaaaaaaaaaaaaaaaaaaaaaaaa
aaappooooooooopoooooooooooooooooooooooooooooooooopppaaaaaaaaaaaaaaaaaaaaaaa
aaapoooooooooopoooooooooooooooooooooooooooooooooooopppaaaaaaaaaaaaaaaaaaaaa
aaapooooooooooRoooooooooooooooooooooooooooooooooooooopppaaaaaaaaaaaaaaaaaaa
aaapoooooooooopoooooooooooooooooooooooooooooooooooooopppaaaaaaaaaaaaaaaaaaa
aaapoooooooooopoooooooooooooooooooooooooooooooooooopppaaaaaaaaaaaaaaaaaaaaa
aaappJJJPdJJJJpoooooooooooooooooooooooooooooooooopppaaaaaaaaaaaaaaaaaaaaaaa
aaaapbbbDDbbbbpoooooooooooooooooooooooooooooooopppaaaaaaaaaaaaaaaaaaaaaaaaa
aaaappbbDDDCbppoooooooooooooooooooooooooooooopppaaaaaaaaaaaaaaaaaaaaaaaaaaa
aaaaapbbDDbbxpoooooooooooooooooooooooooooooopppaaaaaaaaaaaaaaaaaaaaaaaaaaaa
aaaaappbDDbpppppppppppppppppppppppppppppppppppaaaaaaaaaaaaaaaaaaaaaaaaaaaaa
aaaaaapptIppaaaaauuujaaaaaaaaaaaauuujaaaaaaaaaaaaaaaaaaaaaaaaaaaaaaaaaaaaaa
aaaaaaappppaaaaaaajujaaaaaaaaaaaaajujaaaaaaaaaaaaaaaaaaaaaaaaaaaaaaaaaaaaaa
aaaaaaaaaaaaaaaaaajujaaaaaaaaaaaaajujaaaaaaaaaaaaaaaaaaaaaaaaaaaaaaaaaaaaaa
aaaaaaaaaaaaaaaaaajujaaaaaaaaaaaaajujaaaaaaaaaaaaaaaaaaaaaaaaaaaaaaaaaaaaaa
aaaaaaaaaaaaaaaaaajuujaaaaaaaaaaaajuujaaaaaaaaaaaaaaaaaaaaaaaaaaaaaaaaaaaaa
aaaaaaaaaaaaaaaaaajuuujaaaaaaaaaaajuuujaaaaaaaaaaaaaaaaaaaaaaaaaaaaaaaaaaaa
aaaaaaaaaaaaaaaaaajujjaaaaaaaaaaaajujjaaaaaaaaaaaaaaaaaaaaaaaaaaaaaaaaaaaaa
aaaaaaaaaaaaaaaaaajujaaaaaaaaaaaaajujaaaaaaaaaaaaaaaaaaaaaaaaaaaaaaaaaaaaaa
aaaaaaaaaaaaaaaaaaajaaaaaaaaaaaaaaajaaaaaaaaaaaaaaaaaaaaaaaaaaaaaaaaaaaaaaa
aaaaaaaaaaaaaaaaaaaaaaaaaaaaaaaaaaaaaaaaaaaaaaaaaaaaaaaaaaaaaaaaaaaaaaaaaaa
aaaaaaaaaaaaaaaaaaaaaaaaaaaaaaaaaaaaaaaaaaaaaaaaaaaaaaaaaaaaaaaaaaaaaaaaaaa
aaaaaaaaaaaaaaaaaaaaaaaaaaaaaaaaaaaaaaaaaaaaaaaaaaaaaaaaaaaaaaaaaaaaaaaaaaa
aaaaaaaaaaaaaaaaaaaaaaaaaaaaaaaaaaaaaaaaaaaaaaaaaaaaaaaaaaaaaaaaaaaaaaaaaaa
aaaaaaaaaaaaaaaaaaaaaaaaaaaaaaaaaaaaaaaaaaaaaaaaaaaaaaaaaaaaaaaaaaaaaaaaaaa
aaaaaaaaaaaaaaaaaaaaaaaaaaaaaaaaaaaaaaaaaaaaaaaaaaaaaaaaaaaaaaaaaaaaaaaaaaa
aaaaaaaaaaaaaaaaaaaaaaaaaaaaaaaaaaaaaaaaaaaaaaaaaaaaaaaaaaaaaaaaaaaaaaaaaaa
aaaaaaaaaaaaaaaaaaaaaaaaaaaaaaaaaaaaaaaaaaaaaaaaaaaaaaaaaaaaaaaaaaaaaaaaaaa
"}
