"as" = (/obj/item/stack/cannonball/fourteen,/turf/open/floor/wood/airless,/area/shuttle/pirate)
"aF" = (/obj/effect/turf_decal/siding/wood/end,/turf/closed/wall/mineral/wood/nonmetal,/area/shuttle/pirate)
"aL" = (/obj/structure/rack,/obj/item/claymore/cutlass,/obj/item/claymore/cutlass{pixel_x = -4; pixel_y = 4},/obj/item/claymore/cutlass,/obj/effect/turf_decal/siding/wood{dir = 5},/turf/open/floor/wood,/area/shuttle/pirate)
"bl" = (/obj/effect/mob_spawn/ghost_role/human/pirate/skeleton,/obj/effect/turf_decal/siding/wood,/turf/open/floor/wood,/area/shuttle/pirate)
"by" = (/obj/machinery/light/small/directional/south,/obj/effect/turf_decal/siding/wood{dir = 6},/turf/open/floor/wood/airless,/area/shuttle/pirate)
"ch" = (/obj/structure/rack,/obj/item/claymore/cutlass{pixel_x = -4; pixel_y = 4},/obj/item/claymore/cutlass,/obj/item/claymore/cutlass,/obj/item/claymore/cutlass,/obj/item/claymore/cutlass,/obj/machinery/light/small/directional/north,/turf/open/floor/wood,/area/shuttle/pirate)
"cQ" = (/obj/effect/turf_decal/siding/wood/end,/obj/structure/railing{dir = 1},/obj/structure/cannon{dir = 1},/turf/open/floor/plating/airless,/area/shuttle/pirate)
"di" = (/turf/open/floor/wood/airless,/area/shuttle/pirate)
"dA" = (/obj/machinery/piratepad,/turf/open/floor/carpet/royalblack/airless,/area/shuttle/pirate)
"dQ" = (/obj/effect/turf_decal/siding/wood/corner{dir = 1},/turf/open/floor/wood/airless,/area/shuttle/pirate)
"eg" = (/obj/structure/table/wood/fancy/black,/obj/item/vorpalscythe{name = "Headtaker"; force = 20; bonus_force_multiplier = 5; block_chance = 10; wound_bonus = 20; bare_wound_bonus = 25; desc = "The legendary scythe wielded by the red captain, decapitating foes with this weapon makes it significantly stronger"},/turf/open/floor/carpet/red,/area/shuttle/pirate)
"ei" = (/obj/structure/railing{dir = 6},/obj/effect/turf_decal/siding/wood/end{dir = 4},/obj/structure/cannon{dir = 4},/turf/open/floor/plating/airless,/area/shuttle/pirate)
"eA" = (/obj/structure/railing{dir = 5},/obj/effect/turf_decal/siding/wood/end{dir = 4},/obj/structure/cannon{dir = 4},/turf/open/floor/plating/airless,/area/shuttle/pirate)
"eX" = (/obj/effect/turf_decal/siding/wood{dir = 4},/turf/open/floor/wood/airless,/area/shuttle/pirate)
"fa" = (/obj/item/kirbyplants/random/dead,/obj/machinery/light/small/directional/south,/turf/open/floor/stone,/area/shuttle/pirate)
"fm" = (/turf/open/floor/wood/airless{icon = 'icons/obj/stairs.dmi'; base_icon_state = null; icon_state = "stairs_wood"; dir = 4},/area/shuttle/pirate)
"fR" = (/obj/machinery/porta_turret/syndicate/energy{faction = list("pirate")},/turf/closed/wall/mineral/wood/nonmetal,/area/shuttle/pirate)
"fX" = (/obj/structure/rack{icon = 'icons/obj/stationobjs.dmi'; icon_state = "minibar"; name = "skeletal minibar"},/obj/item/reagent_containers/condiment/milk{pixel_x = -5},/obj/item/reagent_containers/condiment/milk{pixel_x = 5},/turf/open/floor/wood,/area/shuttle/pirate)
"gM" = (/obj/machinery/light/small/directional/north,/obj/effect/turf_decal/siding/wood{dir = 1},/turf/open/floor/wood/airless,/area/shuttle/pirate)
"hH" = (/turf/open/floor/wood,/area/shuttle/pirate)
"hL" = (/obj/effect/turf_decal/siding/wood{dir = 4},/obj/machinery/light/small/directional/east,/obj/machinery/light/small/directional/west,/obj/machinery/light/small/directional/west,/turf/open/floor/wood/airless,/area/shuttle/pirate)
"ih" = (/obj/structure/rack,/obj/item/gun/ballistic/shotgun/automatic/combat,/obj/item/gun/ballistic/shotgun/automatic/combat,/obj/item/storage/box/lethalshot,/obj/item/storage/box/lethalshot,/obj/effect/turf_decal/siding/wood{dir = 4},/turf/open/floor/wood,/area/shuttle/pirate)
"iz" = (/turf/closed/wall/mineral/wood/nonmetal,/area/shuttle/pirate)
"iD" = (/obj/effect/turf_decal/siding/wood/end{dir = 8},/turf/open/floor/wood/airless,/area/shuttle/pirate)
"iW" = (/obj/item/reagent_containers/cup/bucket/wooden,/obj/effect/turf_decal/siding/wood{dir = 8},/turf/open/floor/wood,/area/shuttle/pirate)
"jo" = (/obj/machinery/turretid{icon_state = "control_kill"; lethal = 1; locked = 0; pixel_y = -24; req_access = null},/turf/open/floor/wood/airless,/area/shuttle/pirate)
"jB" = (/obj/structure/railing{color = "#4C3117"; dir = 8; name = "wooden railing"},/obj/structure/railing{color = "#4C3117"; dir = 4; name = "wooden railing"},/turf/open/floor/wood/airless,/area/shuttle/pirate)
"jQ" = (/obj/structure/fermenting_barrel/gunpowder,/obj/item/reagent_containers/cup/bucket/wooden,/obj/item/reagent_containers/cup/bucket/wooden,/obj/effect/turf_decal/siding/wood,/turf/open/floor/wood/airless,/area/shuttle/pirate)
"jW" = (/obj/machinery/porta_turret/syndicate/energy{dir = 8; faction = list("pirate")},/turf/closed/wall/mineral/wood/nonmetal,/area/shuttle/pirate)
"ki" = (/obj/structure/fermenting_barrel/gunpowder,/obj/item/reagent_containers/cup/bucket/wooden,/obj/item/reagent_containers/cup/bucket/wooden,/obj/machinery/light/small/directional/west,/turf/open/floor/wood/airless,/area/shuttle/pirate)
"kq" = (/obj/structure/table,/obj/machinery/light/small/directional/west,/turf/open/floor/carpet/royalblack/airless,/area/shuttle/pirate)
"kV" = (/obj/effect/turf_decal/siding/wood/end,/obj/structure/railing,/obj/structure/cannon,/turf/open/floor/plating/airless,/area/shuttle/pirate)
"lP" = (/obj/machinery/light/small/directional/east,/obj/effect/turf_decal/siding/wood{dir = 4},/turf/open/floor/wood,/area/shuttle/pirate)
"mD" = (/obj/machinery/light/small/directional/south,/obj/effect/turf_decal/siding/wood,/turf/open/floor/wood/airless,/area/shuttle/pirate)
"mE" = (/obj/effect/turf_decal/siding/wood,/obj/effect/turf_decal/siding/wood/corner{dir = 1},/obj/item/stack/cannonball/fourteen,/turf/open/floor/wood,/area/shuttle/pirate)
"mQ" = (/obj/effect/turf_decal/siding/wood{dir = 4},/obj/machinery/light/small/directional/east,/turf/open/floor/wood/airless,/area/shuttle/pirate)
"ng" = (/obj/machinery/light/small/directional/east,/obj/effect/turf_decal/siding/wood{dir = 5},/turf/open/floor/wood,/area/shuttle/pirate)
"ni" = (/obj/item/stack/cannonball/the_big_one,/obj/effect/turf_decal/siding/wood/end{dir = 8},/turf/open/floor/wood,/area/shuttle/pirate)
"nu" = (/obj/effect/mapping_helpers/airlock/cutaiwire,/obj/machinery/door/airlock/cult/friendly{name = "Captains Quarters"},/turf/open/floor/carpet/red,/area/shuttle/pirate)
"nF" = (/obj/effect/turf_decal/siding/wood/corner{dir = 8},/turf/open/floor/wood/airless,/area/shuttle/pirate)
"nZ" = (/obj/effect/mob_spawn/ghost_role/human/pirate/skeleton,/obj/effect/turf_decal/siding/wood{dir = 8},/turf/open/floor/wood/airless,/area/shuttle/pirate)
"oA" = (/obj/machinery/computer/piratepad_control{dir = 8},/turf/open/floor/carpet/royalblack/airless,/area/shuttle/pirate)
"ph" = (/obj/structure/rack{icon = 'icons/obj/stationobjs.dmi'; icon_state = "minibar"; name = "skeletal minibar"},/obj/item/reagent_containers/condiment/milk{pixel_x = -5},/obj/item/reagent_containers/condiment/milk{pixel_x = 5},/obj/effect/turf_decal/siding/wood/corner{dir = 1},/turf/open/floor/wood,/area/shuttle/pirate)
"pp" = (/obj/effect/mapping_helpers/airlock/cutaiwire,/obj/machinery/door/airlock/vault{color = "#825427"; name = "Powder Storage"},/turf/open/floor/wood/airless,/area/shuttle/pirate)
"pC" = (/turf/closed/wall/mineral/iron{name = "rough stone wall"; desc = "A wall with rough cobblestones forming a wall"},/area/shuttle/pirate)
"qc" = (/obj/effect/turf_decal/siding/wood{dir = 9},/obj/structure/table/wood,/obj/item/flashlight/flare/torch,/obj/machinery/recharger{pixel_y = 2},/obj/effect/turf_decal/siding/wood,/turf/open/floor/wood/airless,/area/shuttle/pirate)
"ql" = (/obj/effect/mapping_helpers/airlock/cutaiwire,/obj/machinery/door/airlock/vault{color = "#825427"; name = "Powder Storage"},/obj/effect/turf_decal/siding/wood/corner,/turf/open/floor/wood/airless,/area/shuttle/pirate)
"qD" = (/obj/effect/turf_decal/siding/wood{dir = 1},/obj/effect/turf_decal/siding/wood/corner{dir = 8},/turf/open/floor/wood/airless,/area/shuttle/pirate)
"sr" = (/obj/structure/fermenting_barrel/gunpowder,/obj/item/reagent_containers/cup/bucket/wooden,/obj/item/reagent_containers/cup/bucket/wooden,/turf/open/floor/wood/airless,/area/shuttle/pirate)
"st" = (/obj/effect/mob_spawn/corpse/human,/turf/open/floor/carpet/red,/area/shuttle/pirate)
"tn" = (/obj/machinery/computer/monitor{dir = 8},/turf/open/floor/carpet/royalblack/airless,/area/shuttle/pirate)
"tK" = (/obj/effect/turf_decal/siding/wood{dir = 5},/turf/open/floor/wood/airless,/area/shuttle/pirate)
"vb" = (/obj/effect/decal/cleanable/blood,/turf/open/floor/stone,/area/shuttle/pirate)
"vI" = (/obj/structure/rack{icon = 'icons/obj/stationobjs.dmi'; icon_state = "minibar"; name = "skeletal minibar"},/obj/item/reagent_containers/condiment/milk{pixel_x = -5},/obj/item/reagent_containers/condiment/milk{pixel_x = 5},/obj/effect/turf_decal/siding/wood{dir = 1},/turf/open/floor/wood,/area/shuttle/pirate)
"vU" = (/obj/machinery/turretid{icon_state = "control_kill"; lethal = 1; locked = 0; pixel_y = -24; req_access = null},/turf/open/floor/wood,/area/shuttle/pirate)
"wb" = (/obj/machinery/light/small/directional/west,/obj/effect/turf_decal/siding/wood{dir = 8},/obj/effect/turf_decal/siding/wood/corner{dir = 4},/turf/open/floor/wood/airless,/area/shuttle/pirate)
"wV" = (/obj/item/reagent_containers/cup/bucket/wooden,/obj/effect/turf_decal/siding/wood{dir = 9},/turf/open/floor/wood,/area/shuttle/pirate)
"xs" = (/obj/effect/mob_spawn/corpse/human,/turf/open/floor/stone,/area/shuttle/pirate)
"xv" = (/obj/structure/railing{color = "#4C3117"; dir = 8; name = "wooden railing"},/obj/structure/railing/corner{color = "#4C3117"; dir = 4; name = "wooden railing"},/turf/open/floor/wood/airless,/area/shuttle/pirate)
"xA" = (/obj/effect/turf_decal/siding/wood{dir = 6},/turf/open/floor/wood/airless,/area/shuttle/pirate)
"xI" = (/obj/effect/turf_decal/siding/wood/corner,/turf/closed/wall/mineral/wood/nonmetal,/area/shuttle/pirate)
"yo" = (/obj/structure/closet/cabinet{name = "The red captains cabinet"},/obj/item/clothing/shoes/pirate/armored,/obj/item/clothing/under/syndicate/bloodred{name = "blood-red suit"},/obj/item/clothing/suit/hooded/berserker{pressure_resistance = 10; min_cold_protection_temperature = 0; name = "Red captains armor"; desc = "Voices of the lost echo from the armor, looted and passed down through millenia of combat"; resistance_flags = 3},/obj/item/tank/jetpack/oxygen/security{name = "red captains jetpack"; desc = "A tank of compressed oxygen fitted for the red captain"},/obj/item/bedsheet/hos{name = "Red captains cloak"},/obj/item/card/id/advanced/black{trim = /datum/id_trim/pirate/captain; name = "The red captain"},/obj/item/radio/headset/syndicate/alt/leader{name = "red captains headset"},/obj/item/implanter/storage,/turf/open/floor/stone,/area/shuttle/pirate)
"yJ" = (/obj/item/flashlight/flare/candle/infinite,/turf/open/floor/carpet/red,/area/shuttle/pirate)
"zb" = (/obj/effect/mob_spawn/ghost_role/human/pirate/skeleton,/turf/open/floor/wood/airless,/area/shuttle/pirate)
"zh" = (/obj/machinery/porta_turret/syndicate/energy{dir = 1; faction = list("pirate")},/turf/closed/wall/mineral/wood/nonmetal,/area/shuttle/pirate)
"zZ" = (/obj/effect/turf_decal/siding/wood{dir = 1},/turf/open/floor/wood/airless,/area/shuttle/pirate)
"AM" = (/obj/structure/cannon,/turf/open/floor/wood,/area/shuttle/pirate)
"AR" = (/obj/machinery/computer/shuttle/pirate{dir = 8},/turf/open/floor/carpet/royalblack/airless,/area/shuttle/pirate)
"AW" = (/obj/machinery/light/small/directional/west,/turf/open/floor/wood/airless,/area/shuttle/pirate)
"BU" = (/obj/structure/railing,/obj/effect/turf_decal/siding/wood/end,/obj/structure/cannon,/turf/open/floor/plating/airless,/area/shuttle/pirate)
"BW" = (/turf/open/floor/iron/solarpanel/airless,/area/shuttle/pirate)
"Cf" = (/obj/structure/rack{icon = 'icons/obj/stationobjs.dmi'; icon_state = "minibar"; name = "skeletal minibar"},/obj/item/reagent_containers/condiment/milk{pixel_x = -5},/obj/item/reagent_containers/condiment/milk{pixel_x = 5},/obj/effect/turf_decal/siding/wood/corner{dir = 8},/turf/open/floor/wood,/area/shuttle/pirate)
"CC" = (/obj/effect/turf_decal/siding/wood{dir = 8},/turf/open/floor/wood/airless,/area/shuttle/pirate)
"DW" = (/turf/open/floor/carpet/red,/area/shuttle/pirate)
"DY" = (/obj/structure/railing{dir = 1},/obj/effect/turf_decal/siding/wood/end,/obj/structure/cannon{dir = 1},/turf/open/floor/plating/airless,/area/shuttle/pirate)
"Ek" = (/obj/machinery/light/small/directional/west,/obj/effect/turf_decal/siding/wood{dir = 8},/turf/open/floor/wood/airless,/area/shuttle/pirate)
"El" = (/obj/effect/turf_decal/siding/wood{dir = 9},/obj/structure/table/wood,/obj/item/stack/cannonball/fourteen,/obj/item/flashlight/flare/torch,/obj/machinery/light/small/directional/north,/obj/effect/turf_decal/siding/wood{dir = 1},/turf/open/floor/wood/airless,/area/shuttle/pirate)
"EP" = (/obj/effect/turf_decal/siding/wood{dir = 8},/obj/machinery/light/small/directional/west,/turf/open/floor/wood/airless,/area/shuttle/pirate)
"FF" = (/obj/structure/railing{dir = 4},/mob/living/basic/cow,/turf/open/floor/grass,/area/shuttle/pirate)
"FG" = (/obj/effect/turf_decal/siding/wood,/turf/open/floor/wood,/area/shuttle/pirate)
"Gk" = (/obj/effect/decal/cleanable/blood,/obj/item/kirbyplants/random/dead,/obj/machinery/light/small/directional/south,/turf/open/floor/stone,/area/shuttle/pirate)
"GL" = (/obj/machinery/light/small/directional/north,/obj/effect/turf_decal/siding/wood{dir = 1},/turf/open/floor/wood,/area/shuttle/pirate)
"Hl" = (/obj/effect/turf_decal/siding/wood,/turf/open/floor/wood/airless,/area/shuttle/pirate)
"Ic" = (/obj/structure/lattice/catwalk,/turf/open/space/basic,/area/shuttle/pirate)
"Ix" = (/obj/effect/turf_decal/siding/wood/corner{dir = 4},/turf/open/floor/wood/airless,/area/shuttle/pirate)
"Jp" = (/obj/structure/fermenting_barrel/gunpowder,/obj/item/reagent_containers/cup/bucket/wooden,/obj/item/reagent_containers/cup/bucket/wooden,/obj/effect/turf_decal/siding/wood{dir = 1},/turf/open/floor/wood/airless,/area/shuttle/pirate)
"Jx" = (/obj/effect/turf_decal/siding/wood/corner,/obj/effect/mob_spawn/ghost_role/human/pirate/skeleton,/turf/open/floor/wood/airless,/area/shuttle/pirate)
"JU" = (/obj/structure/rack,/obj/item/gun/energy/laser,/obj/item/gun/energy/laser{pixel_x = -3; pixel_y = 6},/obj/item/gun/energy/laser{pixel_y = 3},/obj/item/gun/energy/laser{pixel_y = 3},/obj/item/gun/energy/laser{pixel_y = 3},/obj/item/gun/energy/laser{pixel_y = 3},/obj/item/gun/energy/laser{pixel_y = 3},/obj/effect/turf_decal/siding/wood{dir = 5},/obj/machinery/light/small/directional/north,/turf/open/floor/wood,/area/shuttle/pirate)
"Kz" = (/turf/open/floor/carpet/royalblack/airless,/area/shuttle/pirate)
"KD" = (/mob/living/basic/cow,/turf/open/floor/grass,/area/shuttle/pirate)
"KF" = (/obj/structure/rack,/obj/item/gun/ballistic/shotgun/automatic/combat,/obj/item/gun/ballistic/shotgun/automatic/combat,/obj/item/storage/box/lethalshot,/obj/item/storage/box/lethalshot,/obj/effect/turf_decal/siding/wood/end{dir = 4},/turf/open/floor/wood,/area/shuttle/pirate)
"Lk" = (/obj/item/stack/cannonball/shellball/fourteen,/obj/effect/turf_decal/siding/wood{dir = 9},/turf/open/floor/wood,/area/shuttle/pirate)
"Ls" = (/obj/machinery/door/airlock/vault{color = "#825427"; name = "Ship Armoury"},/obj/effect/mapping_helpers/airlock/cutaiwire,/turf/open/floor/wood/airless,/area/shuttle/pirate)
"LW" = (/obj/effect/turf_decal/siding/wood/end{dir = 1},/obj/structure/railing{dir = 1},/obj/structure/cannon{dir = 1},/turf/open/floor/plating/airless,/area/shuttle/pirate)
"MC" = (/obj/structure/rack{icon = 'icons/obj/stationobjs.dmi'; icon_state = "minibar"; name = "skeletal minibar"},/obj/item/reagent_containers/condiment/milk{pixel_x = 5},/obj/item/reagent_containers/condiment/milk{pixel_x = -5},/turf/open/floor/wood,/area/shuttle/pirate)
"Nl" = (/obj/structure/rack,/obj/item/gun/energy/laser{pixel_y = 3},/obj/item/gun/energy/laser{pixel_x = -3; pixel_y = 6},/obj/item/gun/energy/laser,/obj/item/gun/energy/laser{pixel_y = 3},/obj/item/gun/energy/laser{pixel_y = 3},/obj/item/gun/energy/laser{pixel_y = 3},/obj/item/gun/energy/laser{pixel_y = 3},/obj/effect/turf_decal/siding/wood{dir = 9},/obj/machinery/light/small/directional/north,/turf/open/floor/wood,/area/shuttle/pirate)
"Nz" = (/obj/effect/turf_decal/siding/wood{dir = 9},/obj/structure/table/wood,/obj/item/stack/cannonball/fourteen,/obj/item/flashlight/flare/torch,/obj/machinery/light/small/directional/south,/obj/effect/turf_decal/siding/wood,/turf/open/floor/wood/airless,/area/shuttle/pirate)
"NE" = (/obj/effect/mob_spawn/ghost_role/human/pirate/skeleton,/turf/open/floor/wood,/area/shuttle/pirate)
"NG" = (/obj/item/kirbyplants/random/dead,/turf/open/floor/stone,/area/shuttle/pirate)
"NP" = (/obj/structure/railing{color = "#4C3117"; dir = 8; name = "wooden railing"},/obj/structure/railing{color = "#4C3117"; dir = 8; name = "wooden railing"},/obj/structure/railing{color = "#4C3117"; dir = 4; name = "wooden railing"},/turf/open/floor/wood/airless,/area/shuttle/pirate)
"Oe" = (/obj/structure/rack,/obj/item/claymore/cutlass{pixel_x = -4; pixel_y = 4},/obj/item/claymore/cutlass,/obj/item/claymore/cutlass,/obj/effect/turf_decal/siding/wood{dir = 5},/obj/item/claymore/cutlass,/obj/item/claymore/cutlass,/turf/open/floor/wood,/area/shuttle/pirate)
"Ot" = (/turf/open/space/basic,/area/template_noop)
"Pi" = (/obj/effect/turf_decal/siding/wood/corner{dir = 1},/turf/open/floor/wood,/area/shuttle/pirate)
"PF" = (/obj/structure/table/wood/fancy/black,/obj/item/gun/energy/beam_rifle{lefthand_file = icons/mob/inhands/weapons/melee_lefthand.dmi; righthand_file = icons/mob/inhands/weapons/melee_righthand.dmi; inhand_icon_state = powerfist; icon = 'icons/obj/device_syndie.dmi'; icon_state = "powerfist"; pixel_y = 5; pixel_x = 3; color = #669900; name = "Hand of the red captain"; desc = "A weapon of devestating potential looted from an experimental terran lab."; aiming_time_fire_threshold = 3; projectile_damage = 50},/obj/item/necromantic_stone,/turf/open/floor/carpet/red,/area/shuttle/pirate)
"PM" = (/obj/structure/lattice/catwalk,/obj/structure/railing{color = "#4C3117"; dir = 8; name = "wooden railing"},/turf/open/space/basic,/area/shuttle/pirate)
"PS" = (/obj/structure/closet/crate/freezer/blood,/turf/open/floor/stone,/area/shuttle/pirate)
"QE" = (/obj/structure/closet/crate/coffin{pixel_y = 6; name = "The red captains coffin"},/obj/item/flashlight/flare/candle/infinite{pixel_x = -10; pixel_y = -9},/obj/item/flashlight/flare/candle/infinite{pixel_x = 14; pixel_y = -8},/obj/item/flashlight/flare/candle/infinite{pixel_x = -12; pixel_y = 15},/obj/item/flashlight/flare/candle/infinite{pixel_x = 10; pixel_y = 17},/mob/living/carbon/human/species/vampire{real_name = "The Red Captain"; faction = list("pirate"); name = "The Red Captain"; use_random_name = 0; name_override = "The Red Captain"},/turf/open/floor/carpet/red,/area/shuttle/pirate)
"Ra" = (/obj/machinery/light/small/directional/north,/obj/effect/turf_decal/siding/wood{dir = 5},/turf/open/floor/wood/airless,/area/shuttle/pirate)
"Re" = (/obj/effect/turf_decal/siding/wood{dir = 9},/obj/structure/table/wood,/obj/item/stack/cannonball/fourteen,/obj/item/flashlight/flare/torch,/obj/effect/turf_decal/siding/wood{dir = 6},/turf/open/floor/wood/airless,/area/shuttle/pirate)
"Rk" = (/turf/open/floor/stone,/area/shuttle/pirate)
"Rw" = (/obj/effect/decal/cleanable/blood,/obj/item/flashlight/flare/candle/infinite,/obj/machinery/light/small/directional/north,/turf/open/floor/stone,/area/shuttle/pirate)
"RI" = (/obj/effect/turf_decal/siding/wood,/obj/effect/turf_decal/siding/wood/corner{dir = 4},/turf/open/floor/wood,/area/shuttle/pirate)
"RL" = (/obj/machinery/computer/camera_advanced/shuttle_docker/syndicate/pirate{dir = 8; x_offset = -4; y_offset = -8},/turf/open/floor/carpet/royalblack/airless,/area/shuttle/pirate)
"Sg" = (/obj/item/flashlight/flare/candle/infinite,/turf/open/floor/stone,/area/shuttle/pirate)
"Sx" = (/obj/item/stack/cannonball/emp,/obj/item/stack/cannonball/emp,/obj/item/stack/cannonball/emp{pixel_x = 8; pixel_y = 4},/obj/item/stack/cannonball/emp{pixel_y = -3; pixel_x = -1},/obj/item/stack/cannonball/emp{pixel_y = -5; pixel_x = 6},/obj/effect/turf_decal/siding/wood{dir = 9},/obj/machinery/light/small/directional/north,/obj/item/stack/cannonball/emp{pixel_y = -5; pixel_x = 6},/obj/item/stack/cannonball/emp{pixel_y = -5; pixel_x = 6},/obj/item/stack/cannonball/emp{pixel_y = -5; pixel_x = 6},/obj/item/stack/cannonball/emp{pixel_y = -5; pixel_x = 6},/obj/item/stack/cannonball/emp{pixel_y = -5; pixel_x = 6},/obj/item/stack/cannonball/emp{pixel_y = -5; pixel_x = 6},/obj/item/stack/cannonball/emp{pixel_y = -5; pixel_x = 6},/turf/open/floor/wood,/area/shuttle/pirate)
"SV" = (/obj/effect/decal/cleanable/blood,/turf/open/floor/carpet/red,/area/shuttle/pirate)
"Tc" = (/obj/effect/turf_decal/siding/wood{dir = 9},/obj/structure/table/wood,/obj/item/flashlight/flare/torch,/obj/machinery/recharger{pixel_y = 2},/obj/effect/turf_decal/siding/wood{dir = 1},/turf/open/floor/wood/airless,/area/shuttle/pirate)
"TH" = (/obj/structure/lattice/catwalk,/turf/closed/wall/mineral/wood/nonmetal,/area/shuttle/pirate)
"TP" = (/obj/effect/turf_decal/siding/wood/corner,/turf/open/floor/wood/airless,/area/shuttle/pirate)
"Ug" = (/obj/effect/turf_decal/siding/wood{dir = 8},/obj/structure/closet/cabinet,/obj/item/restraints/legcuffs/bola,/obj/item/restraints/legcuffs/bola,/obj/item/restraints/legcuffs/bola,/obj/item/restraints/legcuffs/bola/tactical,/obj/item/restraints/legcuffs/bola/tactical,/obj/item/restraints/handcuffs/cable,/obj/item/restraints/handcuffs/cable,/obj/item/restraints/handcuffs/cable,/obj/item/restraints/handcuffs/cable,/turf/open/floor/wood,/area/shuttle/pirate)
"Uo" = (/obj/structure/table,/obj/machinery/light/small/directional/west,/obj/item/reagent_containers/cup/glass/bottle/whiskey{pixel_y = 8},/obj/item/reagent_containers/cup/glass{pixel_y = 8; pixel_x = -7},/obj/item/reagent_containers/cup/glass{pixel_y = 7; pixel_x = 8},/turf/open/floor/carpet/royalblack/airless,/area/shuttle/pirate)
"UU" = (/obj/structure/railing{color = "#4C3117"; dir = 4; name = "wooden railing"},/obj/structure/railing{color = "#4C3117"; dir = 8; name = "wooden railing"},/turf/open/floor/wood/airless,/area/shuttle/pirate)
"Vz" = (/obj/effect/turf_decal/siding/wood/corner{dir = 4},/turf/open/floor/wood,/area/shuttle/pirate)
"VN" = (/obj/effect/turf_decal/siding/wood{dir = 1},/turf/open/floor/wood,/area/shuttle/pirate)
"Wj" = (/obj/effect/turf_decal/siding/wood{dir = 9},/obj/structure/table/wood,/obj/item/stack/cannonball/fourteen,/obj/item/flashlight/flare/torch,/obj/effect/turf_decal/siding/wood{dir = 5},/turf/open/floor/wood/airless,/area/shuttle/pirate)
"WD" = (/obj/effect/mapping_helpers/airlock/cutaiwire,/obj/machinery/door/airlock/cult/friendly{name = "Captains Quarters"},/turf/open/floor/carpet/red/airless,/area/shuttle/pirate)
"WH" = (/obj/structure/fermenting_barrel/gunpowder,/obj/item/reagent_containers/cup/bucket/wooden,/obj/item/reagent_containers/cup/bucket/wooden,/obj/machinery/light/small/directional/east,/turf/open/floor/wood/airless,/area/shuttle/pirate)
"Xy" = (/obj/item/stack/sheet/mineral/wood/fifty,/turf/open/floor/wood,/area/shuttle/pirate)
"Yy" = (/obj/machinery/door/airlock/vault{color = "#825427"; name = "Ye Olde Strong Door"},/obj/effect/mapping_helpers/airlock/cutaiwire,/turf/open/floor/wood/airless,/area/shuttle/pirate)
"YG" = (/obj/item/stack/sheet/mineral/wood/fifty,/obj/effect/mob_spawn/ghost_role/human/pirate/skeleton,/turf/open/floor/wood,/area/shuttle/pirate)
"YP" = (/obj/structure/festivus{anchored = 1; color = "#825427"; desc = "A sturdy pole designed to hold the vessel's solar sails in place."; name = "mast"; pixel_x = -16; pixel_y = 2},/turf/closed/wall/mineral/wood/nonmetal,/area/shuttle/pirate)
"YQ" = (/obj/structure/railing{color = "#4C3117"; dir = 1; name = "wooden railing"},/turf/open/floor/wood/airless,/area/shuttle/pirate)
"Zi" = (/obj/item/flashlight/flare/candle/infinite{pixel_x = 14; pixel_y = -8},/turf/open/floor/stone,/area/shuttle/pirate)
"Zk" = (/mob/living/basic/cow,/obj/machinery/light/small/directional/west,/turf/open/floor/grass,/area/shuttle/pirate)
"ZR" = (/obj/structure/window/reinforced/shuttle/survival_pod,/turf/open/floor/wood/airless,/area/shuttle/pirate)

(1,1,1) = {"
OtOtOtOtOtOtOtOtOtOtOtOtOtOtOtOtBWOtOtOtOtOtOtOtOtOtOtOtOtOtOtOtBWOtOtOtOtOtOtOtOtOtOtOtOtOtOtOtOtOtOtOtOt
OtOtOtOtOtOtOtOtOtOtOtOtOtOtOtBWIcBWOtOtOtOtOtOtOtOtOtOtOtOtOtBWIcBWOtOtOtOtOtOtOtOtOtOtOtOtOtOtOtOtOtOtOt
OtOtOtOtOtOtOtOtOtOtOtOtOtOtOtBWIcBWOtOtOtOtOtOtOtOtOtOtOtOtOtBWIcBWOtOtOtOtOtOtOtOtOtOtOtOtOtOtOtOtOtOtOt
OtOtOtOtOtOtOtOtOtOtOtOtOtOtOtBWIcBWBWOtOtOtOtOtOtOtOtOtOtOtOtBWIcBWBWOtOtOtOtOtOtOtOtOtOtOtOtOtOtOtOtOtOt
OtOtOtOtOtOtOtOtOtOtOtOtOtOtOtBWIcIcIcBWOtOtOtOtOtOtOtOtOtOtOtBWIcIcIcBWOtOtOtOtOtOtOtOtOtOtOtOtOtOtOtOtOt
OtOtOtOtOtOtOtOtOtOtOtOtOtOtOtBWIcIcBWOtOtOtOtOtOtOtOtOtOtOtOtBWIcIcBWOtOtOtOtOtOtOtOtOtOtOtOtOtOtOtOtOtOt
OtOtOtOtOtOtOtOtOtOtOtOtOtOtOtBWIcBWOtOtOtOtOtOtOtOtOtOtOtOtOtBWIcBWOtOtOtOtOtOtOtOtOtOtOtOtOtOtOtOtOtOtOt
OtOtOtOtizzhizizOtOtOtOtOtOtOtBWIcBWOtOtOtdiOtOtOtOtOtOtOtOtOtBWIcBWOtOtOtOtOtOtOtOtOtOtOtOtOtOtOtOtOtOtOt
OtOtOtizizNlJUizizOtOtOtOtOtIcIcIcBWOtOtOtUUOtOtOtOtOtOtOtOtPMIcIcBWOtOtOtOtOtOtOtOtOtOtOtOtOtOtOtOtOtOtOt
OtOtzhizLkPiVzaLizizzhLWZRizDYjBTHDYZRizDYUUizDYZRizDYZRizDYjBizDYZRizDYZRaFDYZRizizizOtOtOtOtOtOtOtOtOtOt
OtOtizSxPiXyYGVzchOeiziDqDTczZdiElzZzZTczZdiElzZzZTczZzZElzZdiTczZzZElzZzZTczZzZRaizZRZROtOtOtOtOtOtOtOtOt
OtizizUghHAMAMhHhHihizizEkasdididididiasdididididiasdididididiasdididididiasdidiIxtKZRZRizOtOtOtOtOtOtOtOt
OtiznimEFGblFGFGhHRIKFizCCzbdididididididididididididididididizbdidididididididididizZtKizcQizOtOtOtOtOtOt
jWizizizizizizizLsizizizCCdidixIizqlxIizdidididiizZRZRZRizdidididididiizizppizizdididiIxgMtKizZRizOtOtOtOt
izZkFFwVvIVNGLVNhHVNngizEkHlCfizsrdisrizTPHlnFdiizUodAoAZRdidiTPHlnFfXizsrdisrizdiTPHlnFdiIxJpWjizizZRizOt
izKDFFiWhHhHhHhHNEhHhHYyeXYPEPizkidisrizhLYPnZdifmdidiARZRdidimQYPEPdiizsrdiWHizAWeXYPCCdididiIxzZgMzZzZeA
izKDFFiWNEhHNEhHhHhHhHYyeXYPEPizsrdiWHizeXYPCCdifmjodiRLZRdidimQYPEPdiizkidisrizdieXYPCCdididiTPHlmDHlHlei
izZkFFiWMChHhHvUhHhHlPizwbzZphizsrdisrizIxzZdQdiizkqKztnZRdidiIxzZdQfXizsrdisrizdiIxzZdQdiTPjQReizizZRizOt
jWizpCpCpCnuWDpCpCpCpCizCCzbdiizizppizizdidididiizZRZRZRizdidididididiizizppizizdididiJxmDxAizZRizOtOtOtOt
OtizPSNGRwSVDWRwRkNGPSizCCdididididididididizbdidididididididididididididididididiTPHlxAizBUizOtOtOtOtOtOt
OtizizvbxsyJDWSVQEZiizizEkasdididididiasdididididiaszbdidididiasdididididiasdidiTPxAZRZRizOtOtOtOtOtOtOtOt
OtOtizNGSgSVstSgGkyoiziDdQqcHlHlNzHlHlqcHldiNzHlHlqcHldiNzHlHlqcHlHlNzdidiqcHlHlbyizZRZROtOtOtOtOtOtOtOtOt
OtOtfRizfaDWyJNGizizfRkVZRizBUZRizBUZRizBUUUizBUZRizBUjBizBUZRizBUZRizBUUUizBUZRizizizOtOtOtOtOtOtOtOtOtOt
OtOtOtizizPFegizizOtOtOtOtOtIcIcIcBWOtOtOtUUOtOtOtOtOtNPOtOtIcIcIcBWOtOtxvYQOtOtOtOtOtOtOtOtOtOtOtOtOtOtOt
OtOtOtOtizfRizizOtOtOtOtOtOtOtBWIcBWOtOtOtdiOtOtOtOtOtdiOtOtOtBWIcBWOtOtOtdiOtOtOtOtOtOtOtOtOtOtOtOtOtOtOt
OtOtOtOtOtOtOtOtOtOtOtOtOtOtOtBWIcBWOtOtOtOtOtOtOtOtOtOtOtOtOtBWIcBWOtOtOtOtOtOtOtOtOtOtOtOtOtOtOtOtOtOtOt
OtOtOtOtOtOtOtOtOtOtOtOtOtOtOtBWIcBWOtOtOtOtOtOtOtOtOtOtOtOtOtBWIcBWOtOtOtOtOtOtOtOtOtOtOtOtOtOtOtOtOtOtOt
OtOtOtOtOtOtOtOtOtOtOtOtOtOtOtBWIcIcBWOtOtOtOtOtOtOtOtOtOtOtOtBWIcIcBWOtOtOtOtOtOtOtOtOtOtOtOtOtOtOtOtOtOt
OtOtOtOtOtOtOtOtOtOtOtOtOtOtOtBWIcIcIcBWOtOtOtOtOtOtOtOtOtOtOtBWIcIcIcBWOtOtOtOtOtOtOtOtOtOtOtOtOtOtOtOtOt
OtOtOtOtOtOtOtOtOtOtOtOtOtOtOtBWIcBWBWOtOtOtOtOtOtOtOtOtOtOtOtBWIcBWBWOtOtOtOtOtOtOtOtOtOtOtOtOtOtOtOtOtOt
OtOtOtOtOtOtOtOtOtOtOtOtOtOtOtBWIcBWOtOtOtOtOtOtOtOtOtOtOtOtOtBWIcBWOtOtOtOtOtOtOtOtOtOtOtOtOtOtOtOtOtOtOt
OtOtOtOtOtOtOtOtOtOtOtOtOtOtOtOtBWOtOtOtOtOtOtOtOtOtOtOtOtOtOtOtBWOtOtOtOtOtOtOtOtOtOtOtOtOtOtOtOtOtOtOtOt
"}
