"aq" = (/turf/closed/wall/mineral/wood/nonmetal,/area/shuttle/pirate)
"bs" = (/obj/effect/mob_spawn/ghost_role/human/pirate/skeleton,/obj/effect/turf_decal/siding/wood{dir = 8},/turf/open/floor/wood/airless,/area/shuttle/pirate)
"bx" = (/obj/effect/decal/cleanable/blood,/obj/item/flashlight/flare/candle/infinite,/obj/machinery/light/small/directional/north,/turf/open/floor/stone,/area/shuttle/pirate)
"bQ" = (/obj/effect/turf_decal/siding/wood{dir = 4},/obj/machinery/light/small/directional/east,/obj/machinery/light/small/directional/west,/obj/machinery/light/small/directional/west,/turf/open/floor/wood/airless,/area/shuttle/pirate)
"cB" = (/obj/structure/railing{dir = 4},/mob/living/basic/cow,/turf/open/floor/grass,/area/shuttle/pirate)
"cC" = (/obj/effect/decal/cleanable/blood,/turf/open/floor/carpet/red,/area/shuttle/pirate)
"cL" = (/obj/item/stack/cannonball/emp,/obj/item/stack/cannonball/emp,/obj/item/stack/cannonball/emp{pixel_x = 8; pixel_y = 4},/obj/item/stack/cannonball/emp{pixel_y = -3; pixel_x = -1},/obj/item/stack/cannonball/emp{pixel_y = -5; pixel_x = 6},/obj/effect/turf_decal/siding/wood{dir = 9},/obj/machinery/light/small/directional/north,/obj/item/stack/cannonball/emp{pixel_y = -5; pixel_x = 6},/obj/item/stack/cannonball/emp{pixel_y = -5; pixel_x = 6},/obj/item/stack/cannonball/emp{pixel_y = -5; pixel_x = 6},/obj/item/stack/cannonball/emp{pixel_y = -5; pixel_x = 6},/obj/item/stack/cannonball/emp{pixel_y = -5; pixel_x = 6},/obj/item/stack/cannonball/emp{pixel_y = -5; pixel_x = 6},/obj/item/stack/cannonball/emp{pixel_y = -5; pixel_x = 6},/turf/open/floor/wood,/area/shuttle/pirate)
"cS" = (/obj/effect/turf_decal/siding/wood{dir = 4},/obj/machinery/light/small/directional/east,/turf/open/floor/wood/airless,/area/shuttle/pirate)
"cX" = (/obj/effect/mapping_helpers/airlock/cutaiwire,/obj/machinery/door/airlock/cult/friendly{name = "Captains Quarters"},/obj/structure/fans/tiny/invisible,/turf/open/floor/carpet/red/airless,/area/shuttle/pirate)
"db" = (/obj/machinery/turretid{icon_state = "control_kill"; lethal = 1; locked = 0; pixel_y = -24; req_access = null},/turf/open/floor/wood/airless,/area/shuttle/pirate)
"dy" = (/obj/effect/mob_spawn/ghost_role/human/pirate/skeleton,/turf/open/floor/wood,/area/shuttle/pirate)
"dD" = (/obj/structure/rack,/obj/item/gun/energy/laser,/obj/item/gun/energy/laser{pixel_x = -3; pixel_y = 6},/obj/item/gun/energy/laser{pixel_y = 3},/obj/item/gun/energy/laser{pixel_y = 3},/obj/item/gun/energy/laser{pixel_y = 3},/obj/item/gun/energy/laser{pixel_y = 3},/obj/item/gun/energy/laser{pixel_y = 3},/obj/machinery/light/small/directional/north,/obj/effect/turf_decal/siding/wood{dir = 1},/turf/open/floor/wood,/area/shuttle/pirate)
"dE" = (/obj/effect/turf_decal/siding/wood,/turf/open/floor/wood,/area/shuttle/pirate)
"dN" = (/obj/structure/fermenting_barrel/gunpowder,/obj/item/reagent_containers/cup/bucket/wooden,/obj/item/reagent_containers/cup/bucket/wooden,/obj/machinery/light/small/directional/east,/turf/open/floor/wood/airless,/area/shuttle/pirate)
"dQ" = (/obj/machinery/light/small/directional/west,/obj/effect/turf_decal/siding/wood{dir = 8},/turf/open/floor/wood/airless,/area/shuttle/pirate)
"eg" = (/obj/effect/mapping_helpers/airlock/cutaiwire,/obj/machinery/door/airlock/vault{color = "#825427"; name = "Powder Storage"},/obj/effect/turf_decal/siding/wood/corner,/turf/open/floor/wood/airless,/area/shuttle/pirate)
"eD" = (/obj/structure/rack,/obj/item/claymore/cutlass{pixel_x = -4; pixel_y = 4},/obj/item/claymore/cutlass,/obj/item/claymore/cutlass,/obj/effect/turf_decal/siding/wood{dir = 5},/obj/item/claymore/cutlass,/obj/item/claymore/cutlass,/turf/open/floor/wood,/area/shuttle/pirate)
"eL" = (/obj/structure/closet/crate/freezer/blood,/turf/open/floor/stone,/area/shuttle/pirate)
"eX" = (/obj/effect/turf_decal/siding/wood/end,/turf/closed/wall/mineral/wood/nonmetal,/area/shuttle/pirate)
"fa" = (/obj/item/stack/cannonball/shellball/fourteen,/obj/effect/turf_decal/siding/wood{dir = 9},/turf/open/floor/wood,/area/shuttle/pirate)
"fe" = (/obj/machinery/light/small/directional/north,/obj/effect/turf_decal/siding/wood{dir = 1},/turf/open/floor/wood,/area/shuttle/pirate)
"gg" = (/obj/structure/railing{dir = 6},/obj/effect/turf_decal/siding/wood/end{dir = 4},/obj/structure/cannon{dir = 4},/turf/open/floor/plating/airless,/area/shuttle/pirate)
"gp" = (/obj/effect/turf_decal/siding/wood/end,/obj/structure/railing{dir = 1},/obj/structure/cannon{dir = 1},/turf/open/floor/plating/airless,/area/shuttle/pirate)
"hi" = (/obj/structure/railing{dir = 5},/obj/effect/turf_decal/siding/wood/end{dir = 4},/obj/structure/cannon{dir = 4},/turf/open/floor/plating/airless,/area/shuttle/pirate)
"it" = (/turf/open/space/basic,/area/template_noop)
"iP" = (/obj/structure/table/wood,/obj/machinery/recharger{pixel_y = 2},/obj/effect/turf_decal/siding/wood{dir = 1},/turf/open/floor/wood/airless,/area/shuttle/pirate)
"je" = (/obj/effect/mob_spawn/corpse/human,/turf/open/floor/stone,/area/shuttle/pirate)
"jS" = (/obj/structure/rack,/obj/item/gun/ballistic/shotgun/automatic/combat,/obj/item/gun/ballistic/shotgun/automatic/combat,/obj/item/storage/box/lethalshot,/obj/item/storage/box/lethalshot,/obj/effect/turf_decal/siding/wood/end{dir = 4},/turf/open/floor/wood,/area/shuttle/pirate)
"kl" = (/obj/structure/cannon,/turf/open/floor/wood,/area/shuttle/pirate)
"ld" = (/obj/structure/rack,/obj/item/claymore/cutlass{pixel_x = -4; pixel_y = 4},/obj/item/claymore/cutlass,/obj/item/claymore/cutlass,/obj/item/claymore/cutlass,/obj/item/claymore/cutlass,/obj/machinery/light/small/directional/north,/turf/open/floor/wood,/area/shuttle/pirate)
"lj" = (/obj/structure/table/wood,/obj/machinery/recharger{pixel_y = 2},/obj/effect/turf_decal/siding/wood,/turf/open/floor/wood/airless,/area/shuttle/pirate)
"lM" = (/obj/effect/turf_decal/siding/wood/corner{dir = 8},/turf/open/floor/wood/airless,/area/shuttle/pirate)
"lN" = (/turf/open/floor/stone,/area/shuttle/pirate)
"md" = (/turf/open/floor/iron/solarpanel/airless,/area/shuttle/pirate)
"mf" = (/obj/effect/turf_decal/siding/wood,/obj/effect/turf_decal/siding/wood/corner{dir = 1},/obj/item/stack/cannonball/fourteen,/turf/open/floor/wood,/area/shuttle/pirate)
"mO" = (/obj/effect/turf_decal/siding/wood/end{dir = 8},/turf/open/floor/wood/airless,/area/shuttle/pirate)
"mQ" = (/turf/open/floor/carpet/red,/area/shuttle/pirate)
"nc" = (/mob/living/basic/cow,/obj/machinery/light/small/directional/west,/turf/open/floor/grass,/area/shuttle/pirate)
"nh" = (/obj/structure/railing,/obj/effect/turf_decal/siding/wood/end,/obj/structure/cannon,/turf/open/floor/plating/airless,/area/shuttle/pirate)
"np" = (/obj/machinery/light/small/directional/east,/obj/effect/turf_decal/siding/wood{dir = 4},/turf/open/floor/wood,/area/shuttle/pirate)
"nu" = (/obj/structure/table/wood/fancy/black,/obj/item/gun/energy/beam_rifle{lefthand_file = icons/mob/inhands/weapons/melee_lefthand.dmi; righthand_file = icons/mob/inhands/weapons/melee_righthand.dmi; inhand_icon_state = powerfist; icon = 'icons/obj/device_syndie.dmi'; icon_state = "powerfist"; pixel_y = 5; pixel_x = 3; color = #669900; name = "Hand of the red captain"; desc = "A weapon of devestating potential looted from an experimental terran lab."; aiming_time_fire_threshold = 3; projectile_damage = 50; aiming_time = 3; w_class = 3},/obj/item/necromantic_stone,/turf/open/floor/carpet/red,/area/shuttle/pirate)
"nB" = (/turf/closed/wall/mineral/iron{name = "rough stone wall"; desc = "A wall with rough cobblestones forming a wall"},/area/shuttle/pirate)
"nK" = (/obj/machinery/porta_turret/syndicate/energy{dir = 1; faction = list("pirate")},/turf/closed/wall/mineral/wood/nonmetal,/area/shuttle/pirate)
"oe" = (/turf/open/floor/wood/airless,/area/shuttle/pirate)
"oL" = (/obj/machinery/light/small/directional/south,/obj/effect/turf_decal/siding/wood,/turf/open/floor/wood/airless,/area/shuttle/pirate)
"oZ" = (/obj/effect/turf_decal/siding/wood{dir = 8},/obj/machinery/light/small/directional/west,/turf/open/floor/wood/airless,/area/shuttle/pirate)
"pT" = (/obj/machinery/porta_turret/syndicate/energy{faction = list("pirate")},/turf/closed/wall/mineral/wood/nonmetal,/area/shuttle/pirate)
"pU" = (/obj/machinery/light/small/directional/north,/obj/effect/turf_decal/siding/wood{dir = 1},/turf/open/floor/wood/airless,/area/shuttle/pirate)
"qj" = (/obj/structure/rack,/obj/item/gun/energy/laser{pixel_y = 3},/obj/item/gun/energy/laser{pixel_x = -3; pixel_y = 6},/obj/item/gun/energy/laser,/obj/item/gun/energy/laser{pixel_y = 3},/obj/item/gun/energy/laser{pixel_y = 3},/obj/item/gun/energy/laser{pixel_y = 3},/obj/item/gun/energy/laser{pixel_y = 3},/obj/machinery/light/small/directional/north,/obj/effect/turf_decal/siding/wood{dir = 1},/turf/open/floor/wood,/area/shuttle/pirate)
"ql" = (/obj/effect/turf_decal/siding/wood/corner,/turf/open/floor/wood/airless,/area/shuttle/pirate)
"qm" = (/obj/structure/railing{dir = 1},/obj/effect/turf_decal/siding/wood/end,/obj/structure/cannon{dir = 1},/turf/open/floor/plating/airless,/area/shuttle/pirate)
"qK" = (/obj/effect/turf_decal/siding/wood,/obj/effect/turf_decal/siding/wood/corner{dir = 4},/turf/open/floor/wood,/area/shuttle/pirate)
"qP" = (/obj/structure/rack,/obj/item/gun/ballistic/shotgun/automatic/combat,/obj/item/gun/ballistic/shotgun/automatic/combat,/obj/item/storage/box/lethalshot,/obj/item/storage/box/lethalshot,/obj/effect/turf_decal/siding/wood{dir = 4},/turf/open/floor/wood,/area/shuttle/pirate)
"qX" = (/obj/machinery/porta_turret/syndicate/energy{dir = 8; faction = list("pirate")},/turf/closed/wall/mineral/wood/nonmetal,/area/shuttle/pirate)
"rC" = (/obj/effect/turf_decal/siding/wood{dir = 1},/turf/open/floor/wood,/area/shuttle/pirate)
"rQ" = (/obj/structure/rack{icon = 'icons/obj/stationobjs.dmi'; icon_state = "minibar"; name = "skeletal minibar"},/obj/item/reagent_containers/condiment/milk{pixel_x = -5},/obj/item/reagent_containers/condiment/milk{pixel_x = 5},/obj/effect/turf_decal/siding/wood/corner{dir = 1},/turf/open/floor/wood,/area/shuttle/pirate)
"rR" = (/obj/item/kirbyplants/random/dead,/turf/open/floor/stone,/area/shuttle/pirate)
"sj" = (/obj/structure/table/wood,/obj/item/stack/cannonball/fourteen,/obj/item/flashlight/flare/torch,/obj/effect/turf_decal/siding/wood{dir = 6},/turf/open/floor/wood/airless,/area/shuttle/pirate)
"sv" = (/obj/structure/rack{icon = 'icons/obj/stationobjs.dmi'; icon_state = "minibar"; name = "skeletal minibar"},/obj/item/reagent_containers/condiment/milk{pixel_x = -5},/obj/item/reagent_containers/condiment/milk{pixel_x = 5},/obj/effect/turf_decal/siding/wood{dir = 1},/turf/open/floor/wood,/area/shuttle/pirate)
"sM" = (/obj/structure/table/wood,/obj/item/stack/cannonball/fourteen,/obj/item/flashlight/flare/torch,/obj/effect/turf_decal/siding/wood{dir = 5},/turf/open/floor/wood/airless,/area/shuttle/pirate)
"tc" = (/obj/effect/turf_decal/siding/wood/end{dir = 1},/obj/structure/railing{dir = 1},/obj/structure/cannon{dir = 1},/turf/open/floor/plating/airless,/area/shuttle/pirate)
"tp" = (/obj/effect/turf_decal/siding/wood/corner,/obj/effect/mob_spawn/ghost_role/human/pirate/skeleton,/turf/open/floor/wood/airless,/area/shuttle/pirate)
"tx" = (/obj/effect/turf_decal/siding/wood{dir = 4},/turf/open/floor/wood/airless,/area/shuttle/pirate)
"tH" = (/obj/effect/mapping_helpers/airlock/cutaiwire,/obj/machinery/door/airlock/cult/friendly{name = "Captains Quarters"},/obj/structure/fans/tiny/invisible,/turf/open/floor/carpet/red,/area/shuttle/pirate)
"tI" = (/obj/structure/fermenting_barrel/gunpowder,/obj/item/reagent_containers/cup/bucket/wooden,/obj/item/reagent_containers/cup/bucket/wooden,/obj/machinery/light/small/directional/west,/turf/open/floor/wood/airless,/area/shuttle/pirate)
"tK" = (/obj/structure/table/wood,/obj/item/stack/cannonball/fourteen,/obj/item/flashlight/flare/torch,/obj/machinery/light/small/directional/north,/obj/effect/turf_decal/siding/wood{dir = 1},/turf/open/floor/wood/airless,/area/shuttle/pirate)
"uf" = (/obj/item/kirbyplants/random/dead,/obj/machinery/light/small/directional/south,/turf/open/floor/stone,/area/shuttle/pirate)
"vu" = (/obj/structure/rack{icon = 'icons/obj/stationobjs.dmi'; icon_state = "minibar"; name = "skeletal minibar"},/obj/item/reagent_containers/condiment/milk{pixel_x = -5},/obj/item/reagent_containers/condiment/milk{pixel_x = 5},/turf/open/floor/wood,/area/shuttle/pirate)
"vx" = (/obj/structure/closet/cabinet{name = "The red captains cabinet"},/obj/item/clothing/shoes/pirate/armored,/obj/item/clothing/under/syndicate/bloodred{name = "blood-red suit"},/obj/item/clothing/suit/hooded/berserker{pressure_resistance = 10; min_cold_protection_temperature = 0; name = "Red captains armor"; desc = "Voices of the lost echo from the armor, looted and passed down through millenia of combat"; resistance_flags = 3},/obj/item/tank/jetpack/oxygen/security{name = "red captains jetpack"; desc = "A tank of compressed oxygen fitted for the red captain"},/obj/item/bedsheet/hos{name = "Red captains cloak"},/obj/item/card/id/advanced/black{trim = /datum/id_trim/pirate/captain; name = "The red captain"},/obj/item/radio/headset/syndicate/alt/leader{name = "red captains headset"},/obj/item/implanter/storage,/turf/open/floor/stone,/area/shuttle/pirate)
"vP" = (/obj/item/reagent_containers/cup/bucket/wooden,/obj/effect/turf_decal/siding/wood{dir = 9},/obj/structure/fans/tiny/invisible,/turf/open/floor/wood,/area/shuttle/pirate)
"wp" = (/obj/effect/turf_decal/siding/wood{dir = 8},/turf/open/floor/wood/airless,/area/shuttle/pirate)
"wD" = (/obj/effect/turf_decal/siding/wood/end,/obj/structure/railing,/obj/structure/cannon,/turf/open/floor/plating/airless,/area/shuttle/pirate)
"xo" = (/obj/effect/turf_decal/siding/wood{dir = 1},/obj/effect/turf_decal/siding/wood/corner{dir = 8},/turf/open/floor/wood/airless,/area/shuttle/pirate)
"xL" = (/obj/effect/decal/cleanable/blood,/turf/open/floor/stone,/area/shuttle/pirate)
"yj" = (/obj/structure/railing{color = "#4C3117"; dir = 8; name = "wooden railing"},/obj/structure/railing/corner{color = "#4C3117"; dir = 4; name = "wooden railing"},/turf/open/floor/wood/airless,/area/shuttle/pirate)
"yp" = (/obj/structure/railing{color = "#4C3117"; dir = 1; name = "wooden railing"},/turf/open/floor/wood/airless,/area/shuttle/pirate)
"zm" = (/obj/structure/railing{color = "#4C3117"; dir = 8; name = "wooden railing"},/obj/structure/railing{color = "#4C3117"; dir = 8; name = "wooden railing"},/obj/structure/railing{color = "#4C3117"; dir = 4; name = "wooden railing"},/turf/open/floor/wood/airless,/area/shuttle/pirate)
"zL" = (/obj/effect/turf_decal/siding/wood/corner{dir = 1},/turf/open/floor/wood,/area/shuttle/pirate)
"zV" = (/obj/effect/turf_decal/siding/wood{dir = 1},/turf/open/floor/wood/airless,/area/shuttle/pirate)
"zW" = (/obj/structure/table,/obj/machinery/light/small/directional/west,/obj/item/reagent_containers/cup/glass/bottle/whiskey{pixel_y = 8},/obj/item/reagent_containers/cup/glass{pixel_y = 8; pixel_x = -7},/obj/item/reagent_containers/cup/glass{pixel_y = 7; pixel_x = 8},/turf/open/floor/carpet/royalblack/airless,/area/shuttle/pirate)
"Ag" = (/obj/machinery/computer/piratepad_control{dir = 8},/turf/open/floor/carpet/royalblack/airless,/area/shuttle/pirate)
"Bf" = (/obj/structure/rack,/obj/item/claymore/cutlass,/obj/item/claymore/cutlass{pixel_x = -4; pixel_y = 4},/obj/item/claymore/cutlass,/obj/effect/turf_decal/siding/wood{dir = 5},/turf/open/floor/wood,/area/shuttle/pirate)
"BN" = (/obj/structure/lattice/catwalk,/obj/structure/railing{color = "#4C3117"; dir = 8; name = "wooden railing"},/turf/open/space/basic,/area/shuttle/pirate)
"BQ" = (/obj/item/stack/sheet/mineral/wood/fifty,/turf/open/floor/wood,/area/shuttle/pirate)
"BS" = (/obj/effect/mapping_helpers/airlock/cutaiwire,/obj/machinery/door/airlock/vault{color = "#825427"; name = "Powder Storage"},/turf/open/floor/wood/airless,/area/shuttle/pirate)
"Cx" = (/obj/machinery/light/small/directional/west,/obj/effect/turf_decal/siding/wood{dir = 8},/obj/effect/turf_decal/siding/wood/corner{dir = 4},/turf/open/floor/wood/airless,/area/shuttle/pirate)
"CL" = (/obj/machinery/computer/monitor{dir = 8},/turf/open/floor/carpet/royalblack/airless,/area/shuttle/pirate)
"Dk" = (/obj/structure/lattice/catwalk,/turf/open/space/basic,/area/shuttle/pirate)
"Dq" = (/obj/effect/decal/cleanable/blood,/obj/item/kirbyplants/random/dead,/obj/machinery/light/small/directional/south,/turf/open/floor/stone,/area/shuttle/pirate)
"DR" = (/obj/structure/lattice/catwalk,/turf/closed/wall/mineral/wood/nonmetal,/area/shuttle/pirate)
"DZ" = (/obj/machinery/light/small/directional/south,/obj/effect/turf_decal/siding/wood{dir = 6},/turf/open/floor/wood/airless,/area/shuttle/pirate)
"Ed" = (/turf/open/floor/wood,/area/shuttle/pirate)
"Ee" = (/obj/machinery/light/small/directional/west,/turf/open/floor/wood/airless,/area/shuttle/pirate)
"Fc" = (/obj/effect/turf_decal/siding/wood{dir = 6},/turf/open/floor/wood/airless,/area/shuttle/pirate)
"Fd" = (/obj/effect/turf_decal/siding/wood/corner{dir = 4},/turf/open/floor/wood/airless,/area/shuttle/pirate)
"FI" = (/obj/structure/rack{icon = 'icons/obj/stationobjs.dmi'; icon_state = "minibar"; name = "skeletal minibar"},/obj/item/reagent_containers/condiment/milk{pixel_x = 5},/obj/item/reagent_containers/condiment/milk{pixel_x = -5},/turf/open/floor/wood,/area/shuttle/pirate)
"FL" = (/obj/structure/railing{color = "#4C3117"; dir = 4; name = "wooden railing"},/obj/structure/railing{color = "#4C3117"; dir = 8; name = "wooden railing"},/turf/open/floor/wood/airless,/area/shuttle/pirate)
"Gv" = (/obj/structure/fermenting_barrel/gunpowder,/obj/item/reagent_containers/cup/bucket/wooden,/obj/item/reagent_containers/cup/bucket/wooden,/obj/effect/turf_decal/siding/wood,/turf/open/floor/wood/airless,/area/shuttle/pirate)
"Hn" = (/obj/structure/table,/obj/machinery/light/small/directional/west,/turf/open/floor/carpet/royalblack/airless,/area/shuttle/pirate)
"HP" = (/obj/machinery/computer/camera_advanced/shuttle_docker/whiteship{dir = 8; view_range = 14; x_offset = -4; y_offset = -8; name = "Pirate Navigation Computer"},/turf/open/floor/carpet/royalblack/airless,/area/shuttle/pirate)
"IM" = (/obj/effect/turf_decal/siding/wood/corner,/turf/closed/wall/mineral/wood/nonmetal,/area/shuttle/pirate)
"IR" = (/obj/structure/railing{color = "#4C3117"; dir = 8; name = "wooden railing"},/obj/structure/railing{color = "#4C3117"; dir = 4; name = "wooden railing"},/turf/open/floor/wood/airless,/area/shuttle/pirate)
"IU" = (/obj/structure/table/wood,/obj/item/stack/cannonball/fourteen,/obj/item/flashlight/flare/torch,/obj/machinery/light/small/directional/south,/obj/effect/turf_decal/siding/wood,/turf/open/floor/wood/airless,/area/shuttle/pirate)
"Ji" = (/obj/item/flashlight/flare/candle/infinite,/turf/open/floor/stone,/area/shuttle/pirate)
"Kf" = (/mob/living/basic/cow,/turf/open/floor/grass,/area/shuttle/pirate)
"Ku" = (/obj/effect/mob_spawn/ghost_role/human/pirate/skeleton,/turf/open/floor/wood/airless,/area/shuttle/pirate)
"Lj" = (/obj/machinery/turretid{icon_state = "control_kill"; lethal = 1; locked = 0; pixel_y = -24; req_access = null},/turf/open/floor/wood,/area/shuttle/pirate)
"Lp" = (/obj/structure/window/reinforced/shuttle/survival_pod,/turf/open/floor/wood/airless,/area/shuttle/pirate)
"Lr" = (/obj/structure/fermenting_barrel/gunpowder,/obj/item/reagent_containers/cup/bucket/wooden,/obj/item/reagent_containers/cup/bucket/wooden,/obj/effect/turf_decal/siding/wood{dir = 1},/turf/open/floor/wood/airless,/area/shuttle/pirate)
"LH" = (/obj/item/stack/cannonball/fourteen,/obj/structure/table/wood,/obj/item/flashlight/flare/torch,/turf/open/floor/wood/airless,/area/shuttle/pirate)
"LW" = (/obj/structure/festivus{anchored = 1; color = "#825427"; desc = "A sturdy pole designed to hold the vessel's solar sails in place."; name = "mast"; pixel_x = -16; pixel_y = 2},/turf/closed/wall/mineral/wood/nonmetal,/area/shuttle/pirate)
"NC" = (/obj/item/stack/cannonball/the_big_one,/obj/effect/turf_decal/siding/wood/end{dir = 8},/turf/open/floor/wood,/area/shuttle/pirate)
"Oa" = (/turf/open/floor/carpet/royalblack/airless,/area/shuttle/pirate)
"Pi" = (/obj/effect/turf_decal/siding/wood/corner{dir = 1},/turf/open/floor/wood/airless,/area/shuttle/pirate)
"PB" = (/obj/effect/mob_spawn/corpse/human,/turf/open/floor/carpet/red,/area/shuttle/pirate)
"PN" = (/turf/open/floor/wood/airless{icon = 'icons/obj/stairs.dmi'; base_icon_state = null; icon_state = "stairs_wood"; dir = 4},/area/shuttle/pirate)
"QD" = (/obj/machinery/door/airlock/vault{color = "#825427"; name = "Ye Olde Strong Door"},/obj/effect/mapping_helpers/airlock/cutaiwire,/obj/structure/fans/tiny/invisible,/turf/open/floor/wood/airless,/area/shuttle/pirate)
"Si" = (/obj/effect/turf_decal/siding/wood/corner{dir = 4},/turf/open/floor/wood,/area/shuttle/pirate)
"Sr" = (/obj/structure/rack{icon = 'icons/obj/stationobjs.dmi'; icon_state = "minibar"; name = "skeletal minibar"},/obj/item/reagent_containers/condiment/milk{pixel_x = -5},/obj/item/reagent_containers/condiment/milk{pixel_x = 5},/obj/effect/turf_decal/siding/wood/corner{dir = 8},/turf/open/floor/wood,/area/shuttle/pirate)
"SY" = (/obj/item/flashlight/flare/candle/infinite,/turf/open/floor/carpet/red,/area/shuttle/pirate)
"Ta" = (/obj/machinery/light/small/directional/east,/obj/effect/turf_decal/siding/wood{dir = 5},/turf/open/floor/wood,/area/shuttle/pirate)
"Uk" = (/obj/machinery/computer/shuttle/pirate{dir = 8},/turf/open/floor/carpet/royalblack/airless,/area/shuttle/pirate)
"UK" = (/obj/effect/turf_decal/siding/wood{dir = 8},/obj/structure/closet/cabinet,/obj/item/restraints/legcuffs/bola,/obj/item/restraints/legcuffs/bola,/obj/item/restraints/legcuffs/bola,/obj/item/restraints/legcuffs/bola/tactical,/obj/item/restraints/legcuffs/bola/tactical,/obj/item/restraints/handcuffs/cable,/obj/item/restraints/handcuffs/cable,/obj/item/restraints/handcuffs/cable,/obj/item/restraints/handcuffs/cable,/turf/open/floor/wood,/area/shuttle/pirate)
"UT" = (/obj/effect/turf_decal/siding/wood{dir = 5},/turf/open/floor/wood/airless,/area/shuttle/pirate)
"UZ" = (/obj/machinery/piratepad,/turf/open/floor/carpet/royalblack/airless,/area/shuttle/pirate)
"Vk" = (/obj/item/reagent_containers/cup/bucket/wooden,/obj/effect/turf_decal/siding/wood{dir = 8},/obj/structure/fans/tiny/invisible,/turf/open/floor/wood,/area/shuttle/pirate)
"Vs" = (/obj/structure/table/wood/fancy/black,/obj/item/vorpalscythe{name = "Headtaker"; force = 20; bonus_force_multiplier = 5; block_chance = 10; wound_bonus = 20; bare_wound_bonus = 25; desc = "The legendary scythe wielded by the red captain, decapitating foes with this weapon makes it significantly stronger"; w_class = 3},/turf/open/floor/carpet/red,/area/shuttle/pirate)
"WU" = (/obj/machinery/light/small/directional/north,/obj/effect/turf_decal/siding/wood{dir = 5},/turf/open/floor/wood/airless,/area/shuttle/pirate)
"Xn" = (/obj/effect/turf_decal/siding/wood,/turf/open/floor/wood/airless,/area/shuttle/pirate)
"XS" = (/obj/item/flashlight/flare/candle/infinite{pixel_x = 14; pixel_y = -8},/turf/open/floor/stone,/area/shuttle/pirate)
"Yc" = (/obj/machinery/door/airlock/vault{color = "#825427"; name = "Ship Armoury"},/obj/effect/mapping_helpers/airlock/cutaiwire,/obj/structure/fans/tiny/invisible,/turf/open/floor/wood/airless,/area/shuttle/pirate)
"Ys" = (/obj/item/stack/sheet/mineral/wood/fifty,/obj/effect/mob_spawn/ghost_role/human/pirate/skeleton,/turf/open/floor/wood,/area/shuttle/pirate)
"Ze" = (/obj/effect/mob_spawn/ghost_role/human/pirate/skeleton,/obj/effect/turf_decal/siding/wood,/turf/open/floor/wood,/area/shuttle/pirate)
"Zk" = (/obj/structure/closet/crate/coffin{pixel_y = 6; name = "The red captains coffin"},/obj/item/flashlight/flare/candle/infinite{pixel_x = -10; pixel_y = -9},/obj/item/flashlight/flare/candle/infinite{pixel_x = 14; pixel_y = -8},/obj/item/flashlight/flare/candle/infinite{pixel_x = -12; pixel_y = 15},/obj/item/flashlight/flare/candle/infinite{pixel_x = 10; pixel_y = 17},/mob/living/carbon/human/species/vampire{real_name = "The Red Captain"; faction = list("pirate"); name = "The Red Captain"; use_random_name = 0; name_override = "The Red Captain"},/turf/open/floor/carpet/red,/area/shuttle/pirate)
"Zl" = (/obj/structure/fermenting_barrel/gunpowder,/obj/item/reagent_containers/cup/bucket/wooden,/obj/item/reagent_containers/cup/bucket/wooden,/turf/open/floor/wood/airless,/area/shuttle/pirate)

(1,1,1) = {"
ititititititititititititititititmditititititititititititititititmditititititititititititititititititititit
itititititititititititititititmdDkmditititititititititititititmdDkmdititititititititititititititititititit
itititititititititititititititmdDkmditititititititititititititmdDkmdititititititititititititititititititit
itititititititititititititititmdDkmdmdititititititititititititmdDkmdmditititititititititititititititititit
itititititititititititititititmdDkDkDkmditititititititititititmdDkDkDkmdititititititititititititititititit
itititititititititititititititmdDkDkmdititititititititititititmdDkDkmditititititititititititititititititit
itititititititititititititititmdDkmditititititititititititititmdDkmdititititititititititititititititititit
ititititaqnKaqaqitititititititmdDkmditititoeitititititititititmdDkmdititititititititititititititititititit
itititaqaqaqaqaqaqitititititDkDkDkmditititFLititititititititBNDkDkmdititititititititititititititititititit
ititnKaqfaqjdDBfaqaqnKtcLpaqqmIRDRqmLpaqqmFLaqqmLpaqqmLpaqqmIRaqqmLpaqqmLpeXqmLpaqaqaqitititititititititit
ititaqcLzLBQYsSildeDaqmOxoiPzVoetKzVzViPzVoetKzVzViPzVzVtKzVoeiPzVzVtKzVzViPzVzVWUaqLpLpititititititititit
itaqaqUKEdklklEdEdqPaqaqdQLHoeoeoeoeoeLHoeoeoeoeoeLHoeoeoeoeoeLHoeoeoeoeoeLHoeoeFdUTLpLpaqitititititititit
itaqNCmfdEZedEdEEdqKjSaqwpKuoeoeoeoeoeoeoeoeoeoeoeoeoeoeoeoeoeKuoeoeoeoeoeoeoeoeoeoezVUTaqgpaqitititititit
qXaqaqaqaqaqaqaqYcaqaqaqwpoeoeIMaqegIMaqoeoeoeoeaqLpLpLpaqoeoeoeoeoeoeaqaqBSaqaqoeoeoeFdpUUTaqLpaqitititit
aqnccBvPsvrCferCEdrCTaaqdQXnSraqZloeZlaqqlXnlMoeaqzWUZAgLpoeoeqlXnlMvuaqZloeZlaqoeqlXnlMoeFdLrsMaqaqLpaqit
aqKfcBVkEdEdEdEddyEdEdQDtxLWoZaqtIoeZlaqbQLWbsoePNoeoeUkLpoeoecSLWoZoeaqZloedNaqEetxLWwpoeoeoeFdzVpUzVzVhi
aqKfcBVkdyEddyEdEdEdEdQDtxLWoZaqZloedNaqtxLWwpoePNdboeHPLpoeoecSLWoZoeaqtIoeZlaqoetxLWwpoeoeoeqlXnoLXnXngg
aqnccBVkFIEdEdLjEdEdnpaqCxzVrQaqZloeZlaqFdzVPioeaqHnOaCLLpoeoeFdzVPivuaqZloeZlaqoeFdzVPioeqlGvsjaqaqLpaqit
qXaqnBnBnBtHcXnBnBnBnBaqwpKuoeaqaqBSaqaqoeoeoeoeaqLpLpLpaqoeoeoeoeoeoeaqaqBSaqaqoeoeoetpoLFcaqLpaqitititit
itaqeLrRbxcCmQbxlNrReLaqwpoeoeoeoeoeoeoeoeoeKuoeoeoeoeoeoeoeoeoeoeoeoeoeoeoeoeoeoeqlXnFcaqnhaqitititititit
itaqaqxLjeSYmQcCZkXSaqaqdQLHoeoeoeoeoeLHoeoeoeoeoeLHKuoeoeoeoeLHoeoeoeoeoeLHoeoeqlFcLpLpaqitititititititit
ititaqrRJicCPBJiDqvxaqmOPiljXnXnIUXnXnljXnoeIUXnXnljXnoeIUXnXnljXnXnIUoeoeljXnXnDZaqLpLpititititititititit
ititpTaqufnuVsrRaqaqpTwDLpaqnhLpaqnhLpaqnhFLaqnhLpaqnhIRaqnhLpaqnhLpaqnhFLaqnhLpaqaqaqitititititititititit
itititaqaqaqaqaqaqitititititDkDkDkmditititFLitititititzmititDkDkDkmditityjypititititititititititititititit
ititititaqpTaqaqitititititititmdDkmditititoeitititititoeitititmdDkmditititoeititititititititititititititit
itititititititititititititititmdDkmditititititititititititititmdDkmdititititititititititititititititititit
itititititititititititititititmdDkmditititititititititititititmdDkmdititititititititititititititititititit
itititititititititititititititmdDkDkmdititititititititititititmdDkDkmditititititititititititititititititit
itititititititititititititititmdDkDkDkmditititititititititititmdDkDkDkmdititititititititititititititititit
itititititititititititititititmdDkmdmdititititititititititititmdDkmdmditititititititititititititititititit
itititititititititititititititmdDkmditititititititititititititmdDkmdititititititititititititititititititit
ititititititititititititititititmditititititititititititititititmditititititititititititititititititititit
"}
