"bb" = (/obj/structure/rack{icon = 'icons/obj/stationobjs.dmi'; icon_state = "minibar"; name = "skeletal minibar"},/obj/item/reagent_containers/condiment/milk{pixel_x = -5},/obj/item/reagent_containers/condiment/milk{pixel_x = 5},/turf/open/floor/wood,/area/shuttle/pirate/flying_dutchman)
"be" = (/obj/effect/decal/cleanable/blood,/turf/open/floor/stone,/area/shuttle/pirate/flying_dutchman)
"bt" = (/obj/effect/turf_decal/siding/wood{dir = 9},/obj/structure/table/wood,/obj/item/stack/cannonball/fourteen,/obj/item/flashlight/flare/torch,/obj/effect/turf_decal/siding/wood{dir = 5},/turf/open/floor/wood/airless,/area/shuttle/pirate/flying_dutchman)
"bu" = (/obj/structure/railing{dir = 1},/obj/effect/turf_decal/siding/wood/end,/obj/structure/cannon{dir = 1},/turf/open/floor/plating/airless,/area/shuttle/pirate/flying_dutchman)
"bv" = (/turf/open/floor/wood,/area/shuttle/pirate/flying_dutchman)
"by" = (/obj/machinery/computer/piratepad_control{dir = 8},/turf/open/floor/carpet/royalblack/airless,/area/shuttle/pirate/flying_dutchman)
"cI" = (/obj/machinery/light/small/directional/west,/turf/open/floor/wood/airless,/area/shuttle/pirate/flying_dutchman)
"cR" = (/obj/effect/mapping_helpers/airlock/cutaiwire,/obj/machinery/door/airlock/vault{color = "#825427"; name = "Powder Storage"},/obj/effect/turf_decal/siding/wood/corner,/turf/open/floor/wood/airless,/area/shuttle/pirate/flying_dutchman)
"dc" = (/obj/effect/mob_spawn/corpse/human,/turf/open/floor/stone,/area/shuttle/pirate/flying_dutchman)
"dh" = (/obj/effect/turf_decal/siding/wood,/turf/open/floor/wood,/area/shuttle/pirate/flying_dutchman)
"dn" = (/turf/open/floor/wood/airless{icon = 'icons/obj/stairs.dmi'; base_icon_state = null; icon_state = "stairs_wood"; dir = 4},/area/shuttle/pirate/flying_dutchman)
"ds" = (/turf/open/floor/carpet/red,/area/shuttle/pirate/flying_dutchman)
"dt" = (/obj/effect/mapping_helpers/airlock/cutaiwire,/obj/machinery/door/airlock/vault{color = "#825427"; name = "Powder Storage"},/turf/open/floor/wood/airless,/area/shuttle/pirate/flying_dutchman)
"dA" = (/obj/item/reagent_containers/cup/bucket/wooden,/obj/effect/turf_decal/siding/wood{dir = 8},/turf/open/floor/wood,/area/shuttle/pirate/flying_dutchman)
"dH" = (/obj/structure/lattice/catwalk,/obj/structure/railing{color = "#4C3117"; dir = 8; name = "wooden railing"},/turf/open/space/basic,/area/shuttle/pirate/flying_dutchman)
"ed" = (/obj/effect/turf_decal/siding/wood{dir = 8},/obj/structure/closet/cabinet,/obj/item/restraints/legcuffs/bola,/obj/item/restraints/legcuffs/bola,/obj/item/restraints/legcuffs/bola,/obj/item/restraints/legcuffs/bola/tactical,/obj/item/restraints/legcuffs/bola/tactical,/obj/item/restraints/handcuffs/cable,/obj/item/restraints/handcuffs/cable,/obj/item/restraints/handcuffs/cable,/obj/item/restraints/handcuffs/cable,/turf/open/floor/wood,/area/shuttle/pirate/flying_dutchman)
"eg" = (/obj/effect/turf_decal/siding/wood{dir = 1},/turf/open/floor/wood/airless,/area/shuttle/pirate/flying_dutchman)
"ei" = (/obj/structure/railing{color = "#4C3117"; dir = 8; name = "wooden railing"},/obj/structure/railing{color = "#4C3117"; dir = 4; name = "wooden railing"},/turf/open/floor/wood/airless,/area/shuttle/pirate/flying_dutchman)
"eH" = (/obj/effect/turf_decal/siding/wood/end,/obj/structure/railing{dir = 1},/obj/structure/cannon{dir = 1},/turf/open/floor/plating/airless,/area/shuttle/pirate/flying_dutchman)
"fe" = (/turf/open/floor/iron/solarpanel/airless,/area/shuttle/pirate/flying_dutchman)
"fp" = (/obj/machinery/porta_turret/syndicate/energy{dir = 1; faction = list("pirate")},/turf/closed/wall/mineral/wood/nonmetal,/area/shuttle/pirate/flying_dutchman)
"fF" = (/turf/closed/wall/mineral/wood/nonmetal,/area/shuttle/pirate/flying_dutchman)
"gq" = (/obj/machinery/computer/camera_advanced/shuttle_docker/syndicate/pirate{dir = 8; x_offset = -4; y_offset = -8},/turf/open/floor/carpet/royalblack/airless,/area/shuttle/pirate/flying_dutchman)
"gX" = (/obj/structure/closet/crate/coffin{pixel_y = 6; name = "The red captains coffin"},/obj/item/flashlight/flare/candle/infinite{pixel_x = -10; pixel_y = -9},/obj/item/flashlight/flare/candle/infinite{pixel_x = 14; pixel_y = -8},/obj/item/flashlight/flare/candle/infinite{pixel_x = -12; pixel_y = 15},/obj/item/flashlight/flare/candle/infinite{pixel_x = 10; pixel_y = 17},/mob/living/carbon/human/species/vampire{real_name = "The Red Captain"; faction = list("pirate"); name = "The Red Captain"; use_random_name = 0},/turf/open/floor/carpet/red,/area/shuttle/pirate/flying_dutchman)
"hf" = (/obj/machinery/porta_turret/syndicate/energy{faction = list("pirate")},/turf/closed/wall/mineral/wood/nonmetal,/area/shuttle/pirate/flying_dutchman)
"hI" = (/obj/structure/rack,/obj/item/gun/ballistic/shotgun/automatic/combat,/obj/item/gun/ballistic/shotgun/automatic/combat,/obj/item/storage/box/lethalshot,/obj/item/storage/box/lethalshot,/obj/effect/turf_decal/siding/wood/end{dir = 4},/turf/open/floor/wood,/area/shuttle/pirate/flying_dutchman)
"ii" = (/obj/item/stack/sheet/mineral/wood/fifty,/obj/effect/mob_spawn/ghost_role/human/pirate/skeleton,/turf/open/floor/wood,/area/shuttle/pirate/flying_dutchman)
"il" = (/obj/effect/turf_decal/siding/wood/corner{dir = 1},/turf/open/floor/wood,/area/shuttle/pirate/flying_dutchman)
"iv" = (/obj/structure/railing,/obj/effect/turf_decal/siding/wood/end,/obj/structure/cannon,/turf/open/floor/plating/airless,/area/shuttle/pirate/flying_dutchman)
"jl" = (/obj/machinery/light/small/directional/south,/obj/effect/turf_decal/siding/wood,/turf/open/floor/wood/airless,/area/shuttle/pirate/flying_dutchman)
"js" = (/obj/effect/turf_decal/siding/wood{dir = 8},/obj/machinery/light/small/directional/west,/turf/open/floor/wood/airless,/area/shuttle/pirate/flying_dutchman)
"jy" = (/obj/structure/railing{color = "#4C3117"; dir = 1; name = "wooden railing"},/turf/open/floor/wood/airless,/area/shuttle/pirate/flying_dutchman)
"kj" = (/obj/item/stack/cannonball/shellball/fourteen,/obj/effect/turf_decal/siding/wood{dir = 9},/turf/open/floor/wood,/area/shuttle/pirate/flying_dutchman)
"kO" = (/obj/item/flashlight/flare/candle/infinite,/turf/open/floor/carpet/red,/area/shuttle/pirate/flying_dutchman)
"lx" = (/obj/effect/decal/cleanable/blood,/obj/item/flashlight/flare/candle/infinite,/obj/machinery/light/small/directional/north,/turf/open/floor/stone,/area/shuttle/pirate/flying_dutchman)
"lH" = (/obj/effect/turf_decal/siding/wood,/turf/open/floor/wood/airless,/area/shuttle/pirate/flying_dutchman)
"lT" = (/obj/structure/cannon,/turf/open/floor/wood,/area/shuttle/pirate/flying_dutchman)
"lU" = (/turf/open/floor/carpet/royalblack/airless,/area/shuttle/pirate/flying_dutchman)
"mO" = (/obj/machinery/turretid{icon_state = "control_kill"; lethal = 1; locked = 0; pixel_y = -24; req_access = null},/turf/open/floor/wood/airless,/area/shuttle/pirate/flying_dutchman)
"mP" = (/turf/open/space/basic,/area/template_noop)
"nh" = (/obj/structure/railing{dir = 4},/mob/living/basic/cow,/turf/open/floor/grass,/area/shuttle/pirate/flying_dutchman)
"nq" = (/obj/structure/table,/obj/machinery/light/small/directional/west,/obj/item/reagent_containers/cup/glass/bottle/whiskey{pixel_y = 8},/obj/item/reagent_containers/cup/glass{pixel_y = 8; pixel_x = -7},/obj/item/reagent_containers/cup/glass{pixel_y = 7; pixel_x = 8},/turf/open/floor/carpet/royalblack/airless,/area/shuttle/pirate/flying_dutchman)
"nI" = (/obj/effect/turf_decal/siding/wood/end{dir = 1},/obj/structure/railing{dir = 1},/obj/structure/cannon{dir = 1},/turf/open/floor/plating/airless,/area/shuttle/pirate/flying_dutchman)
"nK" = (/obj/effect/turf_decal/siding/wood{dir = 8},/turf/open/floor/wood/airless,/area/shuttle/pirate/flying_dutchman)
"nW" = (/obj/structure/rack,/obj/item/gun/ballistic/shotgun/automatic/combat,/obj/item/gun/ballistic/shotgun/automatic/combat,/obj/item/storage/box/lethalshot,/obj/item/storage/box/lethalshot,/obj/effect/turf_decal/siding/wood{dir = 4},/turf/open/floor/wood,/area/shuttle/pirate/flying_dutchman)
"og" = (/obj/structure/rack,/obj/item/gun/energy/laser,/obj/item/gun/energy/laser{pixel_x = -3; pixel_y = 6},/obj/item/gun/energy/laser{pixel_y = 3},/obj/item/gun/energy/laser{pixel_y = 3},/obj/item/gun/energy/laser{pixel_y = 3},/obj/item/gun/energy/laser{pixel_y = 3},/obj/item/gun/energy/laser{pixel_y = 3},/obj/effect/turf_decal/siding/wood{dir = 5},/obj/machinery/light/small/directional/north,/turf/open/floor/wood,/area/shuttle/pirate/flying_dutchman)
"ov" = (/obj/structure/rack{icon = 'icons/obj/stationobjs.dmi'; icon_state = "minibar"; name = "skeletal minibar"},/obj/item/reagent_containers/condiment/milk{pixel_x = -5},/obj/item/reagent_containers/condiment/milk{pixel_x = 5},/obj/effect/turf_decal/siding/wood/corner{dir = 1},/turf/open/floor/wood,/area/shuttle/pirate/flying_dutchman)
"oC" = (/obj/item/flashlight/flare/candle/infinite,/turf/open/floor/stone,/area/shuttle/pirate/flying_dutchman)
"pd" = (/obj/structure/fermenting_barrel/gunpowder,/obj/item/reagent_containers/cup/bucket/wooden,/obj/item/reagent_containers/cup/bucket/wooden,/obj/effect/turf_decal/siding/wood{dir = 1},/turf/open/floor/wood/airless,/area/shuttle/pirate/flying_dutchman)
"pj" = (/obj/structure/rack{icon = 'icons/obj/stationobjs.dmi'; icon_state = "minibar"; name = "skeletal minibar"},/obj/item/reagent_containers/condiment/milk{pixel_x = -5},/obj/item/reagent_containers/condiment/milk{pixel_x = 5},/obj/effect/turf_decal/siding/wood/corner{dir = 8},/turf/open/floor/wood,/area/shuttle/pirate/flying_dutchman)
"pn" = (/obj/structure/rack,/obj/item/gun/energy/laser{pixel_y = 3},/obj/item/gun/energy/laser{pixel_x = -3; pixel_y = 6},/obj/item/gun/energy/laser,/obj/item/gun/energy/laser{pixel_y = 3},/obj/item/gun/energy/laser{pixel_y = 3},/obj/item/gun/energy/laser{pixel_y = 3},/obj/item/gun/energy/laser{pixel_y = 3},/obj/effect/turf_decal/siding/wood{dir = 9},/obj/machinery/light/small/directional/north,/turf/open/floor/wood,/area/shuttle/pirate/flying_dutchman)
"pH" = (/obj/structure/closet/cabinet{name = "The red captains cabinet"},/obj/item/clothing/shoes/pirate/armored,/obj/item/clothing/under/syndicate/bloodred{name = "blood-red suit"},/obj/item/clothing/suit/hooded/berserker{pressure_resistance = 10; min_cold_protection_temperature = 0; name = "Red captains armor"; desc = "Voices of the lost echo from the armor, looted and passed down through millenia of combat"; resistance_flags = 3},/obj/item/tank/jetpack/oxygen/security{name = "red captains jetpack"; desc = "A tank of compressed oxygen fitted for the red captain"},/obj/item/bedsheet/hos{name = "Red captains cloak"},/obj/item/card/id/advanced/black{trim = /datum/id_trim/pirate/captain; name = "The red captain"},/obj/item/radio/headset/syndicate/alt/leader{name = "red captains headset"},/obj/item/implanter/storage,/turf/open/floor/stone,/area/shuttle/pirate/flying_dutchman)
"qM" = (/obj/effect/mob_spawn/ghost_role/human/pirate/skeleton,/turf/open/floor/wood,/area/shuttle/pirate/flying_dutchman)
"rI" = (/obj/effect/turf_decal/siding/wood{dir = 9},/obj/structure/table/wood,/obj/item/stack/cannonball/fourteen,/obj/item/flashlight/flare/torch,/obj/effect/turf_decal/siding/wood{dir = 6},/turf/open/floor/wood/airless,/area/shuttle/pirate/flying_dutchman)
"sl" = (/obj/structure/rack{icon = 'icons/obj/stationobjs.dmi'; icon_state = "minibar"; name = "skeletal minibar"},/obj/item/reagent_containers/condiment/milk{pixel_x = 5},/obj/item/reagent_containers/condiment/milk{pixel_x = -5},/turf/open/floor/wood,/area/shuttle/pirate/flying_dutchman)
"sy" = (/obj/effect/mob_spawn/ghost_role/human/pirate/skeleton,/obj/effect/turf_decal/siding/wood,/turf/open/floor/wood,/area/shuttle/pirate/flying_dutchman)
"tn" = (/obj/structure/railing{dir = 6},/obj/effect/turf_decal/siding/wood/end{dir = 4},/obj/structure/cannon{dir = 4},/turf/open/floor/plating/airless,/area/shuttle/pirate/flying_dutchman)
"tN" = (/obj/machinery/light/small/directional/north,/obj/effect/turf_decal/siding/wood{dir = 1},/turf/open/floor/wood/airless,/area/shuttle/pirate/flying_dutchman)
"uV" = (/obj/structure/lattice/catwalk,/turf/open/space/basic,/area/shuttle/pirate/flying_dutchman)
"vh" = (/obj/machinery/piratepad,/turf/open/floor/carpet/royalblack/airless,/area/shuttle/pirate/flying_dutchman)
"vZ" = (/obj/effect/turf_decal/siding/wood{dir = 1},/turf/open/floor/wood,/area/shuttle/pirate/flying_dutchman)
"wL" = (/obj/structure/railing{dir = 5},/obj/effect/turf_decal/siding/wood/end{dir = 4},/obj/structure/cannon{dir = 4},/turf/open/floor/plating/airless,/area/shuttle/pirate/flying_dutchman)
"xm" = (/obj/structure/railing{color = "#4C3117"; dir = 8; name = "wooden railing"},/obj/structure/railing{color = "#4C3117"; dir = 8; name = "wooden railing"},/obj/structure/railing{color = "#4C3117"; dir = 4; name = "wooden railing"},/turf/open/floor/wood/airless,/area/shuttle/pirate/flying_dutchman)
"xR" = (/obj/effect/turf_decal/siding/wood{dir = 4},/turf/open/floor/wood/airless,/area/shuttle/pirate/flying_dutchman)
"yd" = (/obj/machinery/door/airlock/vault{color = "#825427"; name = "Ye Olde Strong Door"},/obj/effect/mapping_helpers/airlock/cutaiwire,/turf/open/floor/wood/airless,/area/shuttle/pirate/flying_dutchman)
"yH" = (/obj/machinery/light/small/directional/north,/obj/effect/turf_decal/siding/wood{dir = 5},/turf/open/floor/wood/airless,/area/shuttle/pirate/flying_dutchman)
"yR" = (/mob/living/basic/cow,/obj/machinery/light/small/directional/west,/turf/open/floor/grass,/area/shuttle/pirate/flying_dutchman)
"yT" = (/obj/structure/rack,/obj/item/claymore/cutlass{pixel_x = -4; pixel_y = 4},/obj/item/claymore/cutlass,/obj/item/claymore/cutlass,/obj/effect/turf_decal/siding/wood{dir = 5},/obj/item/claymore/cutlass,/obj/item/claymore/cutlass,/turf/open/floor/wood,/area/shuttle/pirate/flying_dutchman)
"zo" = (/obj/effect/turf_decal/siding/wood,/obj/effect/turf_decal/siding/wood/corner{dir = 1},/obj/item/stack/cannonball/fourteen,/turf/open/floor/wood,/area/shuttle/pirate/flying_dutchman)
"zp" = (/obj/item/kirbyplants/random/dead,/turf/open/floor/stone,/area/shuttle/pirate/flying_dutchman)
"zw" = (/obj/item/stack/cannonball/emp,/obj/item/stack/cannonball/emp,/obj/item/stack/cannonball/emp{pixel_x = 8; pixel_y = 4},/obj/item/stack/cannonball/emp{pixel_y = -3; pixel_x = -1},/obj/item/stack/cannonball/emp{pixel_y = -5; pixel_x = 6},/obj/effect/turf_decal/siding/wood{dir = 9},/obj/machinery/light/small/directional/north,/obj/item/stack/cannonball/emp{pixel_y = -5; pixel_x = 6},/obj/item/stack/cannonball/emp{pixel_y = -5; pixel_x = 6},/obj/item/stack/cannonball/emp{pixel_y = -5; pixel_x = 6},/obj/item/stack/cannonball/emp{pixel_y = -5; pixel_x = 6},/obj/item/stack/cannonball/emp{pixel_y = -5; pixel_x = 6},/obj/item/stack/cannonball/emp{pixel_y = -5; pixel_x = 6},/obj/item/stack/cannonball/emp{pixel_y = -5; pixel_x = 6},/turf/open/floor/wood,/area/shuttle/pirate/flying_dutchman)
"Ak" = (/obj/effect/turf_decal/siding/wood/corner,/obj/effect/mob_spawn/ghost_role/human/pirate/skeleton,/turf/open/floor/wood/airless,/area/shuttle/pirate/flying_dutchman)
"Ao" = (/obj/structure/window/reinforced/shuttle/survival_pod,/turf/open/floor/wood/airless,/area/shuttle/pirate/flying_dutchman)
"AG" = (/obj/item/stack/cannonball/the_big_one,/obj/effect/turf_decal/siding/wood/end{dir = 8},/turf/open/floor/wood,/area/shuttle/pirate/flying_dutchman)
"Bc" = (/obj/effect/turf_decal/siding/wood/end,/turf/closed/wall/mineral/wood/nonmetal,/area/shuttle/pirate/flying_dutchman)
"Ci" = (/obj/machinery/light/small/directional/north,/obj/effect/turf_decal/siding/wood{dir = 1},/turf/open/floor/wood,/area/shuttle/pirate/flying_dutchman)
"Cj" = (/obj/effect/turf_decal/siding/wood{dir = 9},/obj/structure/table/wood,/obj/item/stack/cannonball/fourteen,/obj/item/flashlight/flare/torch,/obj/machinery/recharger{pixel_y = 2},/obj/effect/turf_decal/siding/wood,/turf/open/floor/wood/airless,/area/shuttle/pirate/flying_dutchman)
"Cx" = (/obj/structure/festivus{anchored = 1; color = "#825427"; desc = "A sturdy pole designed to hold the vessel's solar sails in place."; name = "mast"; pixel_x = -16; pixel_y = 2},/turf/closed/wall/mineral/wood/nonmetal,/area/shuttle/pirate/flying_dutchman)
"Cz" = (/obj/effect/turf_decal/siding/wood/corner,/turf/closed/wall/mineral/wood/nonmetal,/area/shuttle/pirate/flying_dutchman)
"CC" = (/obj/structure/fermenting_barrel/gunpowder,/obj/item/reagent_containers/cup/bucket/wooden,/obj/item/reagent_containers/cup/bucket/wooden,/turf/open/floor/wood/airless,/area/shuttle/pirate/flying_dutchman)
"CV" = (/obj/effect/turf_decal/siding/wood{dir = 9},/obj/structure/table/wood,/obj/item/stack/cannonball/fourteen,/obj/item/flashlight/flare/torch,/obj/machinery/recharger{pixel_y = 2},/obj/effect/turf_decal/siding/wood{dir = 1},/turf/open/floor/wood/airless,/area/shuttle/pirate/flying_dutchman)
"Dk" = (/obj/machinery/light/small/directional/west,/obj/effect/turf_decal/siding/wood{dir = 8},/obj/effect/turf_decal/siding/wood/corner{dir = 4},/turf/open/floor/wood/airless,/area/shuttle/pirate/flying_dutchman)
"DA" = (/obj/effect/turf_decal/siding/wood,/obj/effect/turf_decal/siding/wood/corner{dir = 4},/turf/open/floor/wood,/area/shuttle/pirate/flying_dutchman)
"DG" = (/obj/machinery/light/small/directional/east,/obj/effect/turf_decal/siding/wood{dir = 5},/turf/open/floor/wood,/area/shuttle/pirate/flying_dutchman)
"DV" = (/turf/open/floor/stone,/area/shuttle/pirate/flying_dutchman)
"Eb" = (/obj/effect/turf_decal/siding/wood{dir = 6},/turf/open/floor/wood/airless,/area/shuttle/pirate/flying_dutchman)
"Fz" = (/obj/structure/rack,/obj/item/claymore/cutlass,/obj/item/claymore/cutlass{pixel_x = -4; pixel_y = 4},/obj/item/claymore/cutlass,/obj/effect/turf_decal/siding/wood{dir = 5},/turf/open/floor/wood,/area/shuttle/pirate/flying_dutchman)
"FL" = (/obj/machinery/computer/shuttle/pirate{dir = 8},/turf/open/floor/carpet/royalblack/airless,/area/shuttle/pirate/flying_dutchman)
"Gh" = (/obj/structure/table/wood/fancy/black,/obj/item/gun/energy/beam_rifle{lefthand_file = icons/mob/inhands/weapons/melee_lefthand.dmi; righthand_file = icons/mob/inhands/weapons/melee_righthand.dmi; inhand_icon_state = powerfist; icon = 'icons/obj/device_syndie.dmi'; icon_state = "powerfist"; pixel_y = 5; pixel_x = 3; color = #669900; name = "Hand of the red captain"; desc = "A weapon of devestating potential looted from an experimental terran lab."; aiming_time_fire_threshold = 3; projectile_damage = 50},/obj/item/necromantic_stone,/turf/open/floor/carpet/red,/area/shuttle/pirate/flying_dutchman)
"GD" = (/obj/effect/mob_spawn/ghost_role/human/pirate/skeleton,/obj/effect/turf_decal/siding/wood{dir = 8},/turf/open/floor/wood/airless,/area/shuttle/pirate/flying_dutchman)
"GW" = (/obj/effect/turf_decal/siding/wood/end{dir = 8},/turf/open/floor/wood/airless,/area/shuttle/pirate/flying_dutchman)
"Hj" = (/obj/structure/railing{color = "#4C3117"; dir = 4; name = "wooden railing"},/obj/structure/railing{color = "#4C3117"; dir = 8; name = "wooden railing"},/turf/open/floor/wood/airless,/area/shuttle/pirate/flying_dutchman)
"Hp" = (/obj/effect/mapping_helpers/airlock/cutaiwire,/obj/machinery/door/airlock/cult/friendly{name = "Captains Quarters"},/turf/open/floor/carpet/red/airless,/area/shuttle/pirate/flying_dutchman)
"HL" = (/obj/structure/fermenting_barrel/gunpowder,/obj/item/reagent_containers/cup/bucket/wooden,/obj/item/reagent_containers/cup/bucket/wooden,/obj/effect/turf_decal/siding/wood,/turf/open/floor/wood/airless,/area/shuttle/pirate/flying_dutchman)
"Ih" = (/obj/effect/turf_decal/siding/wood{dir = 9},/obj/structure/table/wood,/obj/item/stack/cannonball/fourteen,/obj/item/flashlight/flare/torch,/obj/machinery/light/small/directional/north,/obj/effect/turf_decal/siding/wood{dir = 1},/turf/open/floor/wood/airless,/area/shuttle/pirate/flying_dutchman)
"It" = (/obj/structure/railing{color = "#4C3117"; dir = 8; name = "wooden railing"},/obj/structure/railing/corner{color = "#4C3117"; dir = 4; name = "wooden railing"},/turf/open/floor/wood/airless,/area/shuttle/pirate/flying_dutchman)
"Iv" = (/obj/structure/rack,/obj/item/claymore/cutlass{pixel_x = -4; pixel_y = 4},/obj/item/claymore/cutlass,/obj/item/claymore/cutlass,/obj/item/claymore/cutlass,/obj/item/claymore/cutlass,/obj/machinery/light/small/directional/north,/turf/open/floor/wood,/area/shuttle/pirate/flying_dutchman)
"IS" = (/obj/item/reagent_containers/cup/bucket/wooden,/obj/effect/turf_decal/siding/wood{dir = 9},/turf/open/floor/wood,/area/shuttle/pirate/flying_dutchman)
"Jf" = (/obj/machinery/light/small/directional/south,/obj/effect/turf_decal/siding/wood{dir = 6},/turf/open/floor/wood/airless,/area/shuttle/pirate/flying_dutchman)
"Jk" = (/obj/structure/table/wood/fancy/black,/obj/item/vorpalscythe{name = "Headtaker"; force = 20; bonus_force_multiplier = 5; block_chance = 10; wound_bonus = 20; bare_wound_bonus = 25; desc = "The legendary scythe wielded by the red captain, decapitating foes with this weapon makes it significantly stronger"},/turf/open/floor/carpet/red,/area/shuttle/pirate/flying_dutchman)
"KF" = (/obj/machinery/light/small/directional/west,/obj/effect/turf_decal/siding/wood{dir = 8},/turf/open/floor/wood/airless,/area/shuttle/pirate/flying_dutchman)
"MP" = (/obj/structure/fermenting_barrel/gunpowder,/obj/item/reagent_containers/cup/bucket/wooden,/obj/item/reagent_containers/cup/bucket/wooden,/obj/machinery/light/small/directional/west,/turf/open/floor/wood/airless,/area/shuttle/pirate/flying_dutchman)
"NP" = (/mob/living/basic/cow,/turf/open/floor/grass,/area/shuttle/pirate/flying_dutchman)
"NS" = (/obj/effect/turf_decal/siding/wood{dir = 4},/obj/machinery/light/small/directional/east,/turf/open/floor/wood/airless,/area/shuttle/pirate/flying_dutchman)
"Oz" = (/obj/effect/turf_decal/siding/wood/end,/obj/structure/railing,/obj/structure/cannon,/turf/open/floor/plating/airless,/area/shuttle/pirate/flying_dutchman)
"ON" = (/obj/structure/closet/crate/freezer/blood,/turf/open/floor/stone,/area/shuttle/pirate/flying_dutchman)
"PE" = (/obj/effect/turf_decal/siding/wood{dir = 1},/obj/effect/turf_decal/siding/wood/corner{dir = 8},/turf/open/floor/wood/airless,/area/shuttle/pirate/flying_dutchman)
"PI" = (/obj/effect/turf_decal/siding/wood/corner{dir = 4},/turf/open/floor/wood,/area/shuttle/pirate/flying_dutchman)
"PR" = (/turf/closed/wall/mineral/iron{name = "rough stone wall"; desc = "A wall with rough cobblestones forming a wall"},/area/shuttle/pirate/flying_dutchman)
"PS" = (/obj/effect/turf_decal/siding/wood/corner{dir = 8},/turf/open/floor/wood/airless,/area/shuttle/pirate/flying_dutchman)
"PW" = (/obj/effect/mob_spawn/corpse/human,/turf/open/floor/carpet/red,/area/shuttle/pirate/flying_dutchman)
"Qu" = (/obj/effect/turf_decal/siding/wood/corner{dir = 1},/turf/open/floor/wood/airless,/area/shuttle/pirate/flying_dutchman)
"Qw" = (/obj/machinery/porta_turret/syndicate/energy{dir = 8; faction = list("pirate")},/turf/closed/wall/mineral/wood/nonmetal,/area/shuttle/pirate/flying_dutchman)
"Rb" = (/obj/machinery/light/small/directional/east,/obj/effect/turf_decal/siding/wood{dir = 4},/turf/open/floor/wood,/area/shuttle/pirate/flying_dutchman)
"RC" = (/obj/structure/table,/obj/machinery/light/small/directional/west,/turf/open/floor/carpet/royalblack/airless,/area/shuttle/pirate/flying_dutchman)
"RD" = (/turf/open/floor/wood/airless,/area/shuttle/pirate/flying_dutchman)
"RE" = (/obj/effect/decal/cleanable/blood,/turf/open/floor/carpet/red,/area/shuttle/pirate/flying_dutchman)
"RO" = (/obj/effect/turf_decal/siding/wood/corner,/turf/open/floor/wood/airless,/area/shuttle/pirate/flying_dutchman)
"RP" = (/obj/effect/turf_decal/siding/wood/corner{dir = 4},/turf/open/floor/wood/airless,/area/shuttle/pirate/flying_dutchman)
"Tz" = (/obj/structure/rack{icon = 'icons/obj/stationobjs.dmi'; icon_state = "minibar"; name = "skeletal minibar"},/obj/item/reagent_containers/condiment/milk{pixel_x = -5},/obj/item/reagent_containers/condiment/milk{pixel_x = 5},/obj/effect/turf_decal/siding/wood{dir = 1},/turf/open/floor/wood,/area/shuttle/pirate/flying_dutchman)
"Uj" = (/obj/structure/lattice/catwalk,/turf/closed/wall/mineral/wood/nonmetal,/area/shuttle/pirate/flying_dutchman)
"US" = (/obj/effect/decal/cleanable/blood,/obj/item/kirbyplants/random/dead,/turf/open/floor/stone,/area/shuttle/pirate/flying_dutchman)
"Vz" = (/obj/effect/turf_decal/siding/wood{dir = 4},/obj/machinery/light/small/directional/east,/obj/machinery/light/small/directional/west,/obj/machinery/light/small/directional/west,/turf/open/floor/wood/airless,/area/shuttle/pirate/flying_dutchman)
"VA" = (/obj/structure/fermenting_barrel/gunpowder,/obj/item/reagent_containers/cup/bucket/wooden,/obj/item/reagent_containers/cup/bucket/wooden,/obj/machinery/light/small/directional/east,/turf/open/floor/wood/airless,/area/shuttle/pirate/flying_dutchman)
"Wj" = (/obj/effect/turf_decal/siding/wood{dir = 5},/turf/open/floor/wood/airless,/area/shuttle/pirate/flying_dutchman)
"WN" = (/obj/effect/mapping_helpers/airlock/cutaiwire,/obj/machinery/door/airlock/cult/friendly{name = "Captains Quarters"},/turf/open/floor/carpet/red,/area/shuttle/pirate/flying_dutchman)
"Xq" = (/obj/effect/mob_spawn/ghost_role/human/pirate/skeleton,/turf/open/floor/wood/airless,/area/shuttle/pirate/flying_dutchman)
"Yi" = (/obj/machinery/turretid{icon_state = "control_kill"; lethal = 1; locked = 0; pixel_y = -24; req_access = null},/turf/open/floor/wood,/area/shuttle/pirate/flying_dutchman)
"Yr" = (/obj/machinery/computer/monitor{dir = 8},/turf/open/floor/carpet/royalblack/airless,/area/shuttle/pirate/flying_dutchman)
"Yu" = (/obj/machinery/door/airlock/vault{color = "#825427"; name = "Ship Armoury"},/obj/effect/mapping_helpers/airlock/cutaiwire,/turf/open/floor/wood/airless,/area/shuttle/pirate/flying_dutchman)
"Yv" = (/obj/item/stack/sheet/mineral/wood/fifty,/turf/open/floor/wood,/area/shuttle/pirate/flying_dutchman)
"YD" = (/obj/effect/turf_decal/siding/wood{dir = 9},/obj/structure/table/wood,/obj/item/stack/cannonball/fourteen,/obj/item/flashlight/flare/torch,/obj/machinery/light/small/directional/south,/obj/effect/turf_decal/siding/wood,/turf/open/floor/wood/airless,/area/shuttle/pirate/flying_dutchman)

(1,1,1) = {"
mPmPmPmPmPmPmPmPmPmPmPmPmPmPmPmPfemPmPmPmPmPmPmPmPmPmPmPmPmPmPmPfemPmPmPmPmPmPmPmPmPmPmPmPmPmPmPmPmPmPmPmP
mPmPmPmPmPmPmPmPmPmPmPmPmPmPmPfeuVfemPmPmPmPmPmPmPmPmPmPmPmPmPfeuVfemPmPmPmPmPmPmPmPmPmPmPmPmPmPmPmPmPmPmP
mPmPmPmPmPmPmPmPmPmPmPmPmPmPmPfeuVfemPmPmPmPmPmPmPmPmPmPmPmPmPfeuVfemPmPmPmPmPmPmPmPmPmPmPmPmPmPmPmPmPmPmP
mPmPmPmPmPmPmPmPmPmPmPmPmPmPmPfeuVfefemPmPmPmPmPmPmPmPmPmPmPmPfeuVfefemPmPmPmPmPmPmPmPmPmPmPmPmPmPmPmPmPmP
mPmPmPmPmPmPmPmPmPmPmPmPmPmPmPfeuVuVuVfemPmPmPmPmPmPmPmPmPmPmPfeuVuVuVfemPmPmPmPmPmPmPmPmPmPmPmPmPmPmPmPmP
mPmPmPmPmPmPmPmPmPmPmPmPmPmPmPfeuVuVfemPmPmPmPmPmPmPmPmPmPmPmPfeuVuVfemPmPmPmPmPmPmPmPmPmPmPmPmPmPmPmPmPmP
mPmPmPmPmPmPmPmPmPmPmPmPmPmPmPfeuVfemPmPmPmPmPmPmPmPmPmPmPmPmPfeuVfemPmPmPmPmPmPmPmPmPmPmPmPmPmPmPmPmPmPmP
mPmPmPmPfFfpfFfFmPmPmPmPmPmPmPfeuVfemPmPmPRDmPmPmPmPmPmPmPmPmPfeuVfemPmPmPmPmPmPmPmPmPmPmPmPmPmPmPmPmPmPmP
mPmPmPfFfFpnogfFfFmPmPmPmPmPuVuVuVfemPmPmPHjmPmPmPmPmPmPmPmPdHuVuVfemPmPmPmPmPmPmPmPmPmPmPmPmPmPmPmPmPmPmP
mPmPfpfFkjilPIFzfFfFfpnIAofFbueiUjbuAofFbuHjfFbuAofFbuAofFbueifFbuAofFbuAoBcbuAofFfFfFmPmPmPmPmPmPmPmPmPmP
mPmPfFzwilYviiPIIvyTfFGWPECVegRDIhegegCVegRDIhegegCVegegIhegRDCVegegIhegegCVegegyHfFAoAomPmPmPmPmPmPmPmPmP
mPfFfFedbvlTlTbvbvnWfFfFKFRDRDRDRDRDRDRDRDRDRDRDRDRDRDRDRDRDRDRDRDRDRDRDRDRDRDRDRPWjAoAofFmPmPmPmPmPmPmPmP
mPfFAGzodhsydhdhbvDAhIfFnKXqRDRDRDRDRDRDRDRDRDRDRDRDRDRDRDRDRDXqRDRDRDRDRDRDRDRDRDRDegWjfFeHfFmPmPmPmPmPmP
QwfFfFfFfFfFfFfFYufFfFfFnKRDRDCzfFcRCzfFRDRDRDRDfFAoAoAofFRDRDRDRDRDRDfFfFdtfFfFRDRDRDRPtNWjfFAofFmPmPmPmP
fFyRnhISTzvZCivZbvvZDGfFKFlHpjfFCCRDCCfFROlHPSRDfFnqvhbyAoRDRDROlHPSbbfFCCRDCCfFRDROlHPSRDRPpdbtfFfFAofFmP
fFNPnhdAbvbvbvbvqMbvbvydxRCxjsfFMPRDCCfFVzCxGDRDdnRDRDFLAoRDRDNSCxjsRDfFCCRDVAfFcIxRCxnKRDRDRDRPegtNegegwL
fFNPnhdAqMbvqMbvbvbvbvydxRCxjsfFCCRDVAfFxRCxnKRDdnmORDgqAoRDRDNSCxjsRDfFMPRDCCfFRDxRCxnKRDRDRDROlHjllHlHtn
fFyRnhdAslbvbvYibvbvRbfFDkegovfFCCRDCCfFRPegQuRDfFRClUYrAoRDRDRPegQubbfFCCRDCCfFRDRPegQuRDROHLrIfFfFAofFmP
QwfFPRPRPRWNHpPRPRPRPRfFnKXqRDfFfFdtfFfFRDRDRDRDfFAoAoAofFRDRDRDRDRDRDfFfFdtfFfFRDRDRDAkjlEbfFAofFmPmPmPmP
mPfFONzplxREdslxDVzpONfFnKRDRDRDRDRDRDRDRDRDXqRDRDRDRDRDRDRDRDRDRDRDRDRDRDRDRDRDRDROlHEbfFivfFmPmPmPmPmPmP
mPfFfFbedckOdsREgXDVfFfFKFRDRDRDRDRDRDRDRDRDRDRDRDRDXqRDRDRDRDRDRDRDRDRDRDRDRDRDROEbAoAofFmPmPmPmPmPmPmPmP
mPmPfFzpoCREPWoCUSpHfFGWQuCjlHlHYDlHlHCjlHRDYDlHlHCjlHRDYDlHlHCjlHlHYDRDRDCjlHlHJffFAoAomPmPmPmPmPmPmPmPmP
mPmPhffFzpdskOzpfFfFhfOzAofFivAofFivAofFivHjfFivAofFiveifFivAofFivAofFivHjfFivAofFfFfFmPmPmPmPmPmPmPmPmPmP
mPmPmPfFfFGhJkfFfFmPmPmPmPmPuVuVuVfemPmPmPHjmPmPmPmPmPxmmPmPuVuVuVfemPmPItjymPmPmPmPmPmPmPmPmPmPmPmPmPmPmP
mPmPmPmPfFhffFfFmPmPmPmPmPmPmPfeuVfemPmPmPRDmPmPmPmPmPRDmPmPmPfeuVfemPmPmPRDmPmPmPmPmPmPmPmPmPmPmPmPmPmPmP
mPmPmPmPmPmPmPmPmPmPmPmPmPmPmPfeuVfemPmPmPmPmPmPmPmPmPmPmPmPmPfeuVfemPmPmPmPmPmPmPmPmPmPmPmPmPmPmPmPmPmPmP
mPmPmPmPmPmPmPmPmPmPmPmPmPmPmPfeuVfemPmPmPmPmPmPmPmPmPmPmPmPmPfeuVfemPmPmPmPmPmPmPmPmPmPmPmPmPmPmPmPmPmPmP
mPmPmPmPmPmPmPmPmPmPmPmPmPmPmPfeuVuVfemPmPmPmPmPmPmPmPmPmPmPmPfeuVuVfemPmPmPmPmPmPmPmPmPmPmPmPmPmPmPmPmPmP
mPmPmPmPmPmPmPmPmPmPmPmPmPmPmPfeuVuVuVfemPmPmPmPmPmPmPmPmPmPmPfeuVuVuVfemPmPmPmPmPmPmPmPmPmPmPmPmPmPmPmPmP
mPmPmPmPmPmPmPmPmPmPmPmPmPmPmPfeuVfefemPmPmPmPmPmPmPmPmPmPmPmPfeuVfefemPmPmPmPmPmPmPmPmPmPmPmPmPmPmPmPmPmP
mPmPmPmPmPmPmPmPmPmPmPmPmPmPmPfeuVfemPmPmPmPmPmPmPmPmPmPmPmPmPfeuVfemPmPmPmPmPmPmPmPmPmPmPmPmPmPmPmPmPmPmP
mPmPmPmPmPmPmPmPmPmPmPmPmPmPmPmPfemPmPmPmPmPmPmPmPmPmPmPmPmPmPmPfemPmPmPmPmPmPmPmPmPmPmPmPmPmPmPmPmPmPmPmP
"}
