"ad" = (/obj/item/kirbyplants/random/dead,/turf/open/floor/stone,/area/shuttle/pirate/flying_dutchman)
"ax" = (/obj/machinery/door/airlock/vault{color = "#825427"; name = "Ye Olde Strong Door"},/obj/effect/mapping_helpers/airlock/cutaiwire,/turf/open/floor/wood/airless,/area/shuttle/pirate/flying_dutchman)
"aK" = (/obj/structure/railing{color = "#4C3117"; dir = 4; name = "wooden railing"},/obj/structure/railing{color = "#4C3117"; dir = 8; name = "wooden railing"},/turf/open/floor/wood/airless,/area/template_noop)
"bq" = (/obj/structure/lattice/catwalk,/turf/closed/wall/mineral/wood/nonmetal,/area/shuttle/pirate/flying_dutchman)
"cL" = (/obj/effect/turf_decal/siding/wood,/turf/open/floor/wood,/area/shuttle/pirate/flying_dutchman)
"cN" = (/turf/open/floor/wood/airless,/area/template_noop)
"db" = (/obj/structure/lattice/catwalk,/obj/structure/railing{color = "#4C3117"; dir = 8; name = "wooden railing"},/turf/open/space/basic,/area/shuttle/pirate/flying_dutchman)
"dn" = (/obj/structure/railing,/obj/effect/turf_decal/siding/wood/end,/obj/structure/cannon,/turf/open/floor/plating/airless,/area/shuttle/pirate/flying_dutchman)
"dM" = (/obj/effect/turf_decal/siding/wood{dir = 8},/obj/structure/closet/cabinet,/obj/item/restraints/legcuffs/bola,/obj/item/restraints/legcuffs/bola,/obj/item/restraints/legcuffs/bola,/obj/item/restraints/legcuffs/bola/tactical,/obj/item/restraints/legcuffs/bola/tactical,/obj/item/restraints/handcuffs/cable,/obj/item/restraints/handcuffs/cable,/obj/item/restraints/handcuffs/cable,/obj/item/restraints/handcuffs/cable,/turf/open/floor/wood,/area/shuttle/pirate/flying_dutchman)
"dQ" = (/obj/structure/railing{color = "#4C3117"; dir = 8; name = "wooden railing"},/obj/structure/railing{color = "#4C3117"; dir = 8; name = "wooden railing"},/obj/structure/railing{color = "#4C3117"; dir = 4; name = "wooden railing"},/turf/open/floor/wood/airless,/area/template_noop)
"ez" = (/obj/machinery/light/small/directional/north,/obj/effect/turf_decal/siding/wood{dir = 1},/turf/open/floor/wood/airless,/area/shuttle/pirate/flying_dutchman)
"eI" = (/obj/effect/mob_spawn/ghost_role/human/pirate/skeleton,/turf/open/floor/wood/airless,/area/shuttle/pirate/flying_dutchman)
"fb" = (/obj/machinery/light/small/directional/south,/obj/effect/turf_decal/siding/wood{dir = 6},/turf/open/floor/wood/airless,/area/shuttle/pirate/flying_dutchman)
"fi" = (/obj/effect/turf_decal/siding/wood/end,/turf/closed/wall/mineral/wood/nonmetal,/area/shuttle/pirate/flying_dutchman)
"fK" = (/obj/item/stack/cannonball/emp,/obj/item/stack/cannonball/emp,/obj/item/stack/cannonball/emp{pixel_x = 8; pixel_y = 4},/obj/item/stack/cannonball/emp{pixel_y = -3; pixel_x = -1},/obj/item/stack/cannonball/emp{pixel_y = -5; pixel_x = 6},/obj/effect/turf_decal/siding/wood{dir = 9},/obj/machinery/light/small/directional/north,/obj/item/stack/cannonball/emp{pixel_y = -5; pixel_x = 6},/obj/item/stack/cannonball/emp{pixel_y = -5; pixel_x = 6},/obj/item/stack/cannonball/emp{pixel_y = -5; pixel_x = 6},/obj/item/stack/cannonball/emp{pixel_y = -5; pixel_x = 6},/obj/item/stack/cannonball/emp{pixel_y = -5; pixel_x = 6},/obj/item/stack/cannonball/emp{pixel_y = -5; pixel_x = 6},/obj/item/stack/cannonball/emp{pixel_y = -5; pixel_x = 6},/turf/open/floor/wood,/area/shuttle/pirate/flying_dutchman)
"fW" = (/obj/effect/mapping_helpers/airlock/cutaiwire,/obj/machinery/door/airlock/cult/friendly{name = "Captains Quarters"},/turf/open/floor/carpet/red/airless,/area/shuttle/pirate/flying_dutchman)
"gt" = (/obj/structure/fermenting_barrel/gunpowder,/obj/item/reagent_containers/cup/bucket/wooden,/obj/item/reagent_containers/cup/bucket/wooden,/obj/machinery/light/small/directional/east,/turf/open/floor/wood/airless,/area/shuttle/pirate/flying_dutchman)
"hp" = (/obj/structure/rack,/obj/item/gun/energy/laser,/obj/item/gun/energy/laser{pixel_x = -3; pixel_y = 6},/obj/item/gun/energy/laser{pixel_y = 3},/obj/item/gun/energy/laser{pixel_y = 3},/obj/item/gun/energy/laser{pixel_y = 3},/obj/item/gun/energy/laser{pixel_y = 3},/obj/item/gun/energy/laser{pixel_y = 3},/obj/effect/turf_decal/siding/wood{dir = 5},/obj/machinery/light/small/directional/north,/turf/open/floor/wood,/area/shuttle/pirate/flying_dutchman)
"hL" = (/obj/structure/railing{color = "#4C3117"; dir = 8; name = "wooden railing"},/obj/structure/railing/corner{color = "#4C3117"; dir = 4; name = "wooden railing"},/turf/open/floor/wood/airless,/area/template_noop)
"hN" = (/obj/machinery/light/small/directional/north,/obj/effect/turf_decal/siding/wood{dir = 5},/turf/open/floor/wood/airless,/area/shuttle/pirate/flying_dutchman)
"id" = (/mob/living/basic/cow,/turf/open/floor/grass,/area/shuttle/pirate/flying_dutchman)
"iv" = (/obj/structure/fermenting_barrel/gunpowder,/obj/item/reagent_containers/cup/bucket/wooden,/obj/item/reagent_containers/cup/bucket/wooden,/obj/machinery/light/small/directional/west,/turf/open/floor/wood/airless,/area/shuttle/pirate/flying_dutchman)
"jk" = (/obj/effect/turf_decal/siding/wood{dir = 1},/obj/effect/turf_decal/siding/wood/corner{dir = 8},/turf/open/floor/wood/airless,/area/shuttle/pirate/flying_dutchman)
"jA" = (/obj/item/stack/cannonball/the_big_one,/obj/effect/turf_decal/siding/wood/end{dir = 8},/turf/open/floor/wood,/area/shuttle/pirate/flying_dutchman)
"jD" = (/obj/effect/turf_decal/siding/wood{dir = 9},/obj/structure/table/wood,/obj/item/stack/cannonball/fourteen,/obj/item/flashlight/flare/torch,/obj/machinery/light/small/directional/north,/obj/effect/turf_decal/siding/wood{dir = 1},/turf/open/floor/wood/airless,/area/shuttle/pirate/flying_dutchman)
"jI" = (/obj/effect/mapping_helpers/airlock/cutaiwire,/obj/machinery/door/airlock/vault{color = "#825427"; name = "Powder Storage"},/obj/effect/turf_decal/siding/wood/corner,/turf/open/floor/wood/airless,/area/shuttle/pirate/flying_dutchman)
"jK" = (/obj/item/flashlight/flare/candle/infinite,/turf/open/floor/stone,/area/shuttle/pirate/flying_dutchman)
"jV" = (/obj/structure/table/wood/fancy/black,/obj/item/vorpalscythe{name = "Headtaker"; force = 20; bonus_force_multiplier = 5; block_chance = 10; wound_bonus = 20; bare_wound_bonus = 25; desc = "The legendary scythe wielded by the red captain, decapitating foes with this weapon makes it significantly stronger"},/turf/open/floor/carpet/red,/area/shuttle/pirate/flying_dutchman)
"jY" = (/obj/item/stack/sheet/mineral/wood/fifty,/obj/effect/mob_spawn/ghost_role/human/pirate/skeleton,/turf/open/floor/wood,/area/shuttle/pirate/flying_dutchman)
"kk" = (/obj/effect/turf_decal/siding/wood/corner,/obj/effect/mob_spawn/ghost_role/human/pirate/skeleton,/turf/open/floor/wood/airless,/area/shuttle/pirate/flying_dutchman)
"kn" = (/obj/structure/railing{dir = 5},/obj/effect/turf_decal/siding/wood/end{dir = 4},/obj/structure/cannon{dir = 4},/turf/open/floor/plating/airless,/area/shuttle/pirate/flying_dutchman)
"kP" = (/obj/machinery/piratepad,/turf/open/floor/carpet/royalblack/airless,/area/shuttle/pirate/flying_dutchman)
"lq" = (/mob/living/basic/cow,/obj/machinery/light/small/directional/west,/turf/open/floor/grass,/area/shuttle/pirate/flying_dutchman)
"ly" = (/obj/structure/cannon,/turf/open/floor/wood,/area/shuttle/pirate/flying_dutchman)
"my" = (/obj/structure/table/wood/fancy/black,/obj/item/gun/energy/beam_rifle{lefthand_file = icons/mob/inhands/weapons/melee_lefthand.dmi; righthand_file = icons/mob/inhands/weapons/melee_righthand.dmi; inhand_icon_state = powerfist; icon = 'icons/obj/device_syndie.dmi'; icon_state = "powerfist"; pixel_y = 5; pixel_x = 3; color = #669900; name = "Hand of the red captain"; desc = "A weapon of devestating potential looted from an experimental terran lab."; aiming_time_fire_threshold = 3; projectile_damage = 50},/obj/item/necromantic_stone,/turf/open/floor/carpet/red,/area/shuttle/pirate/flying_dutchman)
"nG" = (/obj/item/stack/cannonball/shellball/fourteen,/obj/effect/turf_decal/siding/wood{dir = 9},/turf/open/floor/wood,/area/shuttle/pirate/flying_dutchman)
"nW" = (/obj/machinery/computer/monitor{dir = 8},/turf/open/floor/carpet/royalblack/airless,/area/shuttle/pirate/flying_dutchman)
"pb" = (/obj/effect/mob_spawn/corpse/human,/turf/open/floor/carpet/red,/area/shuttle/pirate/flying_dutchman)
"pc" = (/obj/machinery/light/small/directional/south,/obj/effect/turf_decal/siding/wood,/turf/open/floor/wood/airless,/area/shuttle/pirate/flying_dutchman)
"qn" = (/obj/structure/closet/crate/freezer/blood,/turf/open/floor/stone,/area/shuttle/pirate/flying_dutchman)
"qo" = (/obj/machinery/computer/piratepad_control{dir = 8},/turf/open/floor/carpet/royalblack/airless,/area/shuttle/pirate/flying_dutchman)
"sc" = (/obj/structure/rack{icon = 'icons/obj/stationobjs.dmi'; icon_state = "minibar"; name = "skeletal minibar"},/obj/item/reagent_containers/condiment/milk{pixel_x = -5},/obj/item/reagent_containers/condiment/milk{pixel_x = 5},/turf/open/floor/wood,/area/shuttle/pirate/flying_dutchman)
"sd" = (/obj/structure/fermenting_barrel/gunpowder,/obj/item/reagent_containers/cup/bucket/wooden,/obj/item/reagent_containers/cup/bucket/wooden,/turf/open/floor/wood/airless,/area/shuttle/pirate/flying_dutchman)
"so" = (/obj/effect/turf_decal/siding/wood{dir = 9},/obj/structure/table/wood,/obj/item/stack/cannonball/fourteen,/obj/item/flashlight/flare/torch,/obj/machinery/light/small/directional/south,/obj/effect/turf_decal/siding/wood,/turf/open/floor/wood/airless,/area/shuttle/pirate/flying_dutchman)
"su" = (/obj/effect/turf_decal/siding/wood/corner{dir = 8},/turf/open/floor/wood/airless,/area/shuttle/pirate/flying_dutchman)
"sw" = (/obj/effect/turf_decal/siding/wood/corner{dir = 4},/turf/open/floor/wood/airless,/area/shuttle/pirate/flying_dutchman)
"sZ" = (/turf/closed/wall/mineral/iron{name = "rough stone wall"; desc = "A wall with rough cobblestones forming a wall"},/area/shuttle/pirate/flying_dutchman)
"tn" = (/obj/effect/turf_decal/siding/wood/corner{dir = 1},/turf/open/floor/wood,/area/shuttle/pirate/flying_dutchman)
"tW" = (/obj/machinery/door/airlock/vault{color = "#825427"; name = "Ship Armoury"},/obj/effect/mapping_helpers/airlock/cutaiwire,/turf/open/floor/wood/airless,/area/shuttle/pirate/flying_dutchman)
"ue" = (/obj/effect/turf_decal/siding/wood{dir = 4},/turf/open/floor/wood/airless,/area/shuttle/pirate/flying_dutchman)
"up" = (/obj/structure/festivus{anchored = 1; color = "#825427"; desc = "A sturdy pole designed to hold the vessel's solar sails in place."; name = "mast"; pixel_x = -16; pixel_y = 2},/turf/closed/wall/mineral/wood/nonmetal,/area/shuttle/pirate/flying_dutchman)
"ux" = (/obj/structure/window/reinforced/shuttle/survival_pod,/turf/open/floor/wood/airless,/area/shuttle/pirate/flying_dutchman)
"uy" = (/obj/machinery/porta_turret/syndicate/energy{dir = 1; faction = list("pirate")},/turf/closed/wall/mineral/wood/nonmetal,/area/shuttle/pirate/flying_dutchman)
"uI" = (/obj/effect/decal/cleanable/blood,/turf/open/floor/carpet/red,/area/shuttle/pirate/flying_dutchman)
"vs" = (/obj/effect/turf_decal/siding/wood,/turf/open/floor/wood/airless,/area/shuttle/pirate/flying_dutchman)
"vE" = (/obj/effect/turf_decal/siding/wood{dir = 9},/obj/structure/table/wood,/obj/item/stack/cannonball/fourteen,/obj/item/flashlight/flare/torch,/obj/machinery/recharger{pixel_y = 2},/obj/effect/turf_decal/siding/wood{dir = 1},/turf/open/floor/wood/airless,/area/shuttle/pirate/flying_dutchman)
"vH" = (/obj/item/stack/sheet/mineral/wood/fifty,/turf/open/floor/wood,/area/shuttle/pirate/flying_dutchman)
"vR" = (/obj/machinery/light/small/directional/west,/turf/open/floor/wood/airless,/area/shuttle/pirate/flying_dutchman)
"vT" = (/obj/effect/turf_decal/siding/wood{dir = 6},/turf/open/floor/wood/airless,/area/shuttle/pirate/flying_dutchman)
"wg" = (/obj/structure/fermenting_barrel/gunpowder,/obj/item/reagent_containers/cup/bucket/wooden,/obj/item/reagent_containers/cup/bucket/wooden,/obj/effect/turf_decal/siding/wood{dir = 1},/turf/open/floor/wood/airless,/area/shuttle/pirate/flying_dutchman)
"wq" = (/obj/structure/rack,/obj/item/claymore/cutlass{pixel_x = -4; pixel_y = 4},/obj/item/claymore/cutlass,/obj/item/claymore/cutlass,/obj/item/claymore/cutlass,/obj/item/claymore/cutlass,/obj/machinery/light/small/directional/north,/turf/open/floor/wood,/area/shuttle/pirate/flying_dutchman)
"wU" = (/obj/item/reagent_containers/cup/bucket/wooden,/obj/effect/turf_decal/siding/wood{dir = 9},/turf/open/floor/wood,/area/shuttle/pirate/flying_dutchman)
"wX" = (/obj/structure/rack{icon = 'icons/obj/stationobjs.dmi'; icon_state = "minibar"; name = "skeletal minibar"},/obj/item/reagent_containers/condiment/milk{pixel_x = -5},/obj/item/reagent_containers/condiment/milk{pixel_x = 5},/obj/effect/turf_decal/siding/wood/corner{dir = 8},/turf/open/floor/wood,/area/shuttle/pirate/flying_dutchman)
"ya" = (/obj/machinery/light/small/directional/north,/obj/effect/turf_decal/siding/wood{dir = 1},/turf/open/floor/wood,/area/shuttle/pirate/flying_dutchman)
"yi" = (/turf/open/floor/stone,/area/shuttle/pirate/flying_dutchman)
"yp" = (/obj/effect/turf_decal/siding/wood{dir = 8},/turf/open/floor/wood/airless,/area/shuttle/pirate/flying_dutchman)
"zG" = (/obj/structure/rack,/obj/item/gun/energy/laser{pixel_y = 3},/obj/item/gun/energy/laser{pixel_x = -3; pixel_y = 6},/obj/item/gun/energy/laser,/obj/item/gun/energy/laser{pixel_y = 3},/obj/item/gun/energy/laser{pixel_y = 3},/obj/item/gun/energy/laser{pixel_y = 3},/obj/item/gun/energy/laser{pixel_y = 3},/obj/effect/turf_decal/siding/wood{dir = 9},/obj/machinery/light/small/directional/north,/turf/open/floor/wood,/area/shuttle/pirate/flying_dutchman)
"zO" = (/obj/effect/mob_spawn/ghost_role/human/pirate/skeleton,/obj/effect/turf_decal/siding/wood{dir = 8},/turf/open/floor/wood/airless,/area/shuttle/pirate/flying_dutchman)
"Ag" = (/obj/effect/decal/cleanable/blood,/obj/item/flashlight/flare/candle/infinite,/obj/machinery/light/small/directional/north,/turf/open/floor/stone,/area/shuttle/pirate/flying_dutchman)
"Ay" = (/obj/item/reagent_containers/cup/bucket/wooden,/obj/effect/turf_decal/siding/wood{dir = 8},/turf/open/floor/wood,/area/shuttle/pirate/flying_dutchman)
"AK" = (/obj/effect/turf_decal/siding/wood{dir = 9},/obj/structure/table/wood,/obj/item/stack/cannonball/fourteen,/obj/item/flashlight/flare/torch,/obj/effect/turf_decal/siding/wood{dir = 6},/turf/open/floor/wood/airless,/area/shuttle/pirate/flying_dutchman)
"AS" = (/obj/structure/table,/obj/machinery/light/small/directional/west,/obj/item/reagent_containers/cup/glass/bottle/whiskey{pixel_y = 8},/obj/item/reagent_containers/cup/glass{pixel_y = 8; pixel_x = -7},/obj/item/reagent_containers/cup/glass{pixel_y = 7; pixel_x = 8},/turf/open/floor/carpet/royalblack/airless,/area/shuttle/pirate/flying_dutchman)
"AT" = (/obj/effect/turf_decal/siding/wood/corner{dir = 4},/turf/open/floor/wood,/area/shuttle/pirate/flying_dutchman)
"BC" = (/obj/effect/turf_decal/siding/wood{dir = 1},/turf/open/floor/wood/airless,/area/shuttle/pirate/flying_dutchman)
"Cb" = (/obj/machinery/turretid{icon_state = "control_kill"; lethal = 1; locked = 0; pixel_y = -24; req_access = null},/turf/open/floor/wood,/area/shuttle/pirate/flying_dutchman)
"Dj" = (/obj/effect/turf_decal/siding/wood{dir = 8},/obj/machinery/light/small/directional/west,/turf/open/floor/wood/airless,/area/shuttle/pirate/flying_dutchman)
"Dw" = (/obj/structure/rack{icon = 'icons/obj/stationobjs.dmi'; icon_state = "minibar"; name = "skeletal minibar"},/obj/item/reagent_containers/condiment/milk{pixel_x = -5},/obj/item/reagent_containers/condiment/milk{pixel_x = 5},/obj/effect/turf_decal/siding/wood{dir = 1},/turf/open/floor/wood,/area/shuttle/pirate/flying_dutchman)
"DN" = (/turf/closed/wall/mineral/wood/nonmetal,/area/shuttle/pirate/flying_dutchman)
"Ec" = (/obj/effect/turf_decal/siding/wood/corner,/turf/closed/wall/mineral/wood/nonmetal,/area/shuttle/pirate/flying_dutchman)
"EU" = (/obj/structure/railing{color = "#4C3117"; dir = 1; name = "wooden railing"},/turf/open/floor/wood/airless,/area/template_noop)
"Fn" = (/obj/item/flashlight/flare/candle/infinite,/turf/open/floor/carpet/red,/area/shuttle/pirate/flying_dutchman)
"FR" = (/obj/structure/rack,/obj/item/claymore/cutlass,/obj/item/claymore/cutlass{pixel_x = -4; pixel_y = 4},/obj/item/claymore/cutlass,/obj/effect/turf_decal/siding/wood{dir = 5},/turf/open/floor/wood,/area/shuttle/pirate/flying_dutchman)
"FZ" = (/obj/structure/railing{color = "#4C3117"; dir = 4; name = "wooden railing"},/obj/structure/railing{color = "#4C3117"; dir = 8; name = "wooden railing"},/turf/open/floor/wood/airless,/area/shuttle/pirate/flying_dutchman)
"Gq" = (/obj/structure/rack,/obj/item/claymore/cutlass{pixel_x = -4; pixel_y = 4},/obj/item/claymore/cutlass,/obj/item/claymore/cutlass,/obj/effect/turf_decal/siding/wood{dir = 5},/obj/item/claymore/cutlass,/obj/item/claymore/cutlass,/turf/open/floor/wood,/area/shuttle/pirate/flying_dutchman)
"Gr" = (/obj/machinery/porta_turret/syndicate/energy{dir = 8; faction = list("pirate")},/turf/closed/wall/mineral/wood/nonmetal,/area/shuttle/pirate/flying_dutchman)
"Gx" = (/obj/machinery/light/small/directional/west,/obj/effect/turf_decal/siding/wood{dir = 8},/obj/effect/turf_decal/siding/wood/corner{dir = 4},/turf/open/floor/wood/airless,/area/shuttle/pirate/flying_dutchman)
"GG" = (/obj/effect/decal/cleanable/blood,/turf/open/floor/stone,/area/shuttle/pirate/flying_dutchman)
"GI" = (/obj/structure/rack,/obj/item/gun/ballistic/shotgun/automatic/combat,/obj/item/gun/ballistic/shotgun/automatic/combat,/obj/item/storage/box/lethalshot,/obj/item/storage/box/lethalshot,/obj/effect/turf_decal/siding/wood{dir = 4},/turf/open/floor/wood,/area/shuttle/pirate/flying_dutchman)
"GQ" = (/obj/effect/turf_decal/siding/wood,/obj/effect/turf_decal/siding/wood/corner{dir = 1},/obj/item/stack/cannonball/fourteen,/turf/open/floor/wood,/area/shuttle/pirate/flying_dutchman)
"HC" = (/obj/effect/turf_decal/siding/wood,/obj/effect/turf_decal/siding/wood/corner{dir = 4},/turf/open/floor/wood,/area/shuttle/pirate/flying_dutchman)
"HR" = (/obj/structure/railing{dir = 4},/mob/living/basic/cow,/turf/open/floor/grass,/area/shuttle/pirate/flying_dutchman)
"In" = (/obj/effect/mob_spawn/corpse/human,/turf/open/floor/stone,/area/shuttle/pirate/flying_dutchman)
"Jc" = (/obj/effect/turf_decal/siding/wood/end,/obj/structure/railing,/obj/structure/cannon,/turf/open/floor/plating/airless,/area/shuttle/pirate/flying_dutchman)
"Jw" = (/turf/open/floor/wood/airless,/area/shuttle/pirate/flying_dutchman)
"JH" = (/obj/effect/turf_decal/siding/wood{dir = 9},/obj/structure/table/wood,/obj/item/stack/cannonball/fourteen,/obj/item/flashlight/flare/torch,/obj/machinery/recharger{pixel_y = 2},/obj/effect/turf_decal/siding/wood,/turf/open/floor/wood/airless,/area/shuttle/pirate/flying_dutchman)
"JX" = (/obj/effect/mob_spawn/ghost_role/human/pirate/skeleton,/obj/effect/turf_decal/siding/wood,/turf/open/floor/wood,/area/shuttle/pirate/flying_dutchman)
"Kq" = (/obj/effect/turf_decal/siding/wood{dir = 4},/obj/machinery/light/small/directional/east,/turf/open/floor/wood/airless,/area/shuttle/pirate/flying_dutchman)
"KB" = (/obj/structure/rack{icon = 'icons/obj/stationobjs.dmi'; icon_state = "minibar"; name = "skeletal minibar"},/obj/item/reagent_containers/condiment/milk{pixel_x = 5},/obj/item/reagent_containers/condiment/milk{pixel_x = -5},/turf/open/floor/wood,/area/shuttle/pirate/flying_dutchman)
"KR" = (/obj/machinery/light/small/directional/east,/obj/effect/turf_decal/siding/wood{dir = 4},/turf/open/floor/wood,/area/shuttle/pirate/flying_dutchman)
"Lh" = (/obj/effect/turf_decal/siding/wood{dir = 9},/obj/structure/table/wood,/obj/item/stack/cannonball/fourteen,/obj/item/flashlight/flare/torch,/obj/effect/turf_decal/siding/wood{dir = 5},/turf/open/floor/wood/airless,/area/shuttle/pirate/flying_dutchman)
"Lv" = (/obj/effect/mapping_helpers/airlock/cutaiwire,/obj/machinery/door/airlock/cult/friendly{name = "Captains Quarters"},/turf/open/floor/carpet/red,/area/shuttle/pirate/flying_dutchman)
"LD" = (/obj/effect/turf_decal/siding/wood{dir = 1},/turf/open/floor/wood,/area/shuttle/pirate/flying_dutchman)
"LJ" = (/obj/machinery/porta_turret/syndicate/energy{faction = list("pirate")},/turf/closed/wall/mineral/wood/nonmetal,/area/shuttle/pirate/flying_dutchman)
"LO" = (/obj/effect/turf_decal/siding/wood/end{dir = 1},/obj/structure/railing{dir = 1},/obj/structure/cannon{dir = 1},/turf/open/floor/plating/airless,/area/shuttle/pirate/flying_dutchman)
"Mj" = (/obj/effect/turf_decal/siding/wood{dir = 5},/turf/open/floor/wood/airless,/area/shuttle/pirate/flying_dutchman)
"MR" = (/obj/machinery/computer/shuttle/pirate{dir = 8},/turf/open/floor/carpet/royalblack/airless,/area/shuttle/pirate/flying_dutchman)
"Ns" = (/obj/structure/railing{color = "#4C3117"; dir = 8; name = "wooden railing"},/obj/structure/railing{color = "#4C3117"; dir = 4; name = "wooden railing"},/turf/open/floor/wood/airless,/area/shuttle/pirate/flying_dutchman)
"NB" = (/obj/structure/railing{dir = 1},/obj/effect/turf_decal/siding/wood/end,/obj/structure/cannon{dir = 1},/turf/open/floor/plating/airless,/area/shuttle/pirate/flying_dutchman)
"NO" = (/obj/structure/closet/cabinet{name = "The red captains cabinet"},/obj/item/clothing/shoes/pirate/armored,/obj/item/clothing/under/syndicate/bloodred{name = "blood-red suit"},/obj/item/clothing/suit/hooded/berserker{pressure_resistance = 10; min_cold_protection_temperature = 0; name = "Red captains armor"; desc = "Voices of the lost echo from the armor, looted and passed down through millenia of combat"; resistance_flags = 3},/obj/item/tank/jetpack/oxygen/security{name = "red captains jetpack"; desc = "A tank of compressed oxygen fitted for the red captain"},/obj/item/bedsheet/hos{name = "Red captains cloak"},/obj/item/card/id/advanced/black{trim = /datum/id_trim/pirate/captain; name = "The red captain"},/obj/item/radio/headset/syndicate/alt/leader{name = "red captains headset"},/turf/open/floor/stone,/area/shuttle/pirate/flying_dutchman)
"NQ" = (/obj/effect/mob_spawn/ghost_role/human/pirate/skeleton,/turf/open/floor/wood,/area/shuttle/pirate/flying_dutchman)
"OH" = (/obj/structure/table,/obj/machinery/light/small/directional/west,/turf/open/floor/carpet/royalblack/airless,/area/shuttle/pirate/flying_dutchman)
"Pw" = (/obj/effect/turf_decal/siding/wood/corner,/turf/open/floor/wood/airless,/area/shuttle/pirate/flying_dutchman)
"Py" = (/obj/effect/turf_decal/siding/wood/end{dir = 8},/turf/open/floor/wood/airless,/area/shuttle/pirate/flying_dutchman)
"PP" = (/turf/open/floor/carpet/royalblack/airless,/area/shuttle/pirate/flying_dutchman)
"PQ" = (/obj/structure/rack{icon = 'icons/obj/stationobjs.dmi'; icon_state = "minibar"; name = "skeletal minibar"},/obj/item/reagent_containers/condiment/milk{pixel_x = -5},/obj/item/reagent_containers/condiment/milk{pixel_x = 5},/obj/effect/turf_decal/siding/wood/corner{dir = 1},/turf/open/floor/wood,/area/shuttle/pirate/flying_dutchman)
"Qs" = (/obj/structure/closet/crate/coffin{pixel_y = 6; name = "The red captains coffin"},/obj/item/flashlight/flare/candle/infinite{pixel_x = -10; pixel_y = -9},/obj/item/flashlight/flare/candle/infinite{pixel_x = 14; pixel_y = -8},/obj/item/flashlight/flare/candle/infinite{pixel_x = -12; pixel_y = 15},/obj/item/flashlight/flare/candle/infinite{pixel_x = 10; pixel_y = 17},/mob/living/carbon/human/species/vampire{real_name = "The red captain"; faction = list("pirate")},/turf/open/floor/carpet/red,/area/shuttle/pirate/flying_dutchman)
"Qz" = (/turf/open/floor/wood,/area/shuttle/pirate/flying_dutchman)
"QA" = (/turf/open/floor/carpet/red,/area/shuttle/pirate/flying_dutchman)
"QM" = (/obj/machinery/computer/camera_advanced/shuttle_docker/syndicate/pirate{dir = 8; x_offset = -4; y_offset = -8},/turf/open/floor/carpet/royalblack/airless,/area/shuttle/pirate/flying_dutchman)
"QT" = (/obj/structure/rack,/obj/item/gun/ballistic/shotgun/automatic/combat,/obj/item/gun/ballistic/shotgun/automatic/combat,/obj/item/storage/box/lethalshot,/obj/item/storage/box/lethalshot,/obj/effect/turf_decal/siding/wood/end{dir = 4},/turf/open/floor/wood,/area/shuttle/pirate/flying_dutchman)
"QX" = (/turf/open/space/basic,/area/template_noop)
"RC" = (/obj/machinery/light/small/directional/east,/obj/effect/turf_decal/siding/wood{dir = 5},/turf/open/floor/wood,/area/shuttle/pirate/flying_dutchman)
"RO" = (/obj/effect/decal/cleanable/blood,/obj/item/kirbyplants/random/dead,/turf/open/floor/stone,/area/shuttle/pirate/flying_dutchman)
"RP" = (/obj/structure/lattice/catwalk,/turf/open/space/basic,/area/shuttle/pirate/flying_dutchman)
"Sl" = (/obj/effect/mapping_helpers/airlock/cutaiwire,/obj/machinery/door/airlock/vault{color = "#825427"; name = "Powder Storage"},/turf/open/floor/wood/airless,/area/shuttle/pirate/flying_dutchman)
"Tm" = (/obj/machinery/turretid{icon_state = "control_kill"; lethal = 1; locked = 0; pixel_y = -24; req_access = null},/turf/open/floor/wood/airless,/area/shuttle/pirate/flying_dutchman)
"Tt" = (/obj/effect/turf_decal/siding/wood/corner{dir = 1},/turf/open/floor/wood/airless,/area/shuttle/pirate/flying_dutchman)
"Uk" = (/obj/structure/railing{dir = 6},/obj/effect/turf_decal/siding/wood/end{dir = 4},/obj/structure/cannon{dir = 4},/turf/open/floor/plating/airless,/area/shuttle/pirate/flying_dutchman)
"UT" = (/obj/structure/stairs/wood{dir = 4},/turf/open/floor/wood/airless,/area/shuttle/pirate/flying_dutchman)
"Wc" = (/obj/structure/fermenting_barrel/gunpowder,/obj/item/reagent_containers/cup/bucket/wooden,/obj/item/reagent_containers/cup/bucket/wooden,/obj/effect/turf_decal/siding/wood,/turf/open/floor/wood/airless,/area/shuttle/pirate/flying_dutchman)
"Wr" = (/turf/open/floor/iron/solarpanel/airless,/area/shuttle/pirate/flying_dutchman)
"Yh" = (/obj/effect/turf_decal/siding/wood/end,/obj/structure/railing{dir = 1},/obj/structure/cannon{dir = 1},/turf/open/floor/plating/airless,/area/shuttle/pirate/flying_dutchman)
"Zw" = (/obj/machinery/light/small/directional/west,/obj/effect/turf_decal/siding/wood{dir = 8},/turf/open/floor/wood/airless,/area/shuttle/pirate/flying_dutchman)

(1,1,1) = {"
QXQXQXQXQXQXQXQXQXQXQXQXQXQXQXQXWrQXQXQXQXQXQXQXQXQXQXQXQXQXQXQXWrQXQXQXQXQXQXQXQXQXQXQXQXQXQXQXQXQXQXQXQX
QXQXQXQXQXQXQXQXQXQXQXQXQXQXQXWrRPWrQXQXQXQXQXQXQXQXQXQXQXQXQXWrRPWrQXQXQXQXQXQXQXQXQXQXQXQXQXQXQXQXQXQXQX
QXQXQXQXQXQXQXQXQXQXQXQXQXQXQXWrRPWrQXQXQXQXQXQXQXQXQXQXQXQXQXWrRPWrQXQXQXQXQXQXQXQXQXQXQXQXQXQXQXQXQXQXQX
QXQXQXQXQXQXQXQXQXQXQXQXQXQXQXWrRPWrWrQXQXQXQXQXQXQXQXQXQXQXQXWrRPWrWrQXQXQXQXQXQXQXQXQXQXQXQXQXQXQXQXQXQX
QXQXQXQXQXQXQXQXQXQXQXQXQXQXQXWrRPRPRPWrQXQXQXQXQXQXQXQXQXQXQXWrRPRPRPWrQXQXQXQXQXQXQXQXQXQXQXQXQXQXQXQXQX
QXQXQXQXQXQXQXQXQXQXQXQXQXQXQXWrRPRPWrQXQXQXQXQXQXQXQXQXQXQXQXWrRPRPWrQXQXQXQXQXQXQXQXQXQXQXQXQXQXQXQXQXQX
QXQXQXQXQXQXQXQXQXQXQXQXQXQXQXWrRPWrQXQXQXQXQXQXQXQXQXQXQXQXQXWrRPWrQXQXQXQXQXQXQXQXQXQXQXQXQXQXQXQXQXQXQX
QXQXQXQXDNuyDNDNQXQXQXQXQXQXQXWrRPWrQXQXQXcNQXQXQXQXQXQXQXQXQXWrRPWrQXQXQXQXQXQXQXQXQXQXQXQXQXQXQXQXQXQXQX
QXQXQXDNDNzGhpDNDNQXQXQXQXQXRPRPRPWrQXQXQXaKQXQXQXQXQXQXQXQXdbRPRPWrQXQXQXQXQXQXQXQXQXQXQXQXQXQXQXQXQXQXQX
QXQXuyDNnGtnATFRDNDNuyLOuxDNNBNsbqNBuxDNNBFZDNNBuxDNNBuxDNNBNsDNNBuxDNNBuxfiNBuxDNDNDNQXQXQXQXQXQXQXQXQXQX
QXQXDNfKtnvHjYATwqGqDNPyjkvEBCJwjDBCBCvEBCJwjDBCBCvEBCBCjDBCJwvEBCBCjDBCBCvEBCBChNDNuxuxQXQXQXQXQXQXQXQXQX
QXDNDNdMQzlylyQzQzGIDNDNZwJwJwJwJwJwJwJwJwJwJwJwJwJwJwJwJwJwJwJwJwJwJwJwJwJwJwJwswMjuxuxDNQXQXQXQXQXQXQXQX
QXDNjAGQcLJXcLcLQzHCQTDNypeIJwJwJwJwJwJwJwJwJwJwJwJwJwJwJwJwJweIJwJwJwJwJwJwJwJwJwJwBCMjDNYhDNQXQXQXQXQXQX
GrDNDNDNDNDNDNDNtWDNDNDNypJwJwEcDNjIEcDNJwJwJwJwDNuxuxuxDNJwJwJwJwJwJwDNDNSlDNDNJwJwJwswezMjDNuxDNQXQXQXQX
DNlqHRwUDwLDyaLDQzLDRCDNZwvswXDNsdJwsdDNPwvssuJwDNASkPqouxJwJwPwvssuscDNsdJwsdDNJwPwvssuJwswwgLhDNDNuxDNQX
DNidHRAyQzQzQzQzNQQzQzaxueupDjDNivJwsdDNKqupzOJwUTJwJwMRuxJwJwueupDjJwDNsdJwgtDNvRueupypJwJwJwswBCezBCBCkn
DNidHRAyNQQzNQQzQzQzQzaxueupDjDNsdJwgtDNueupypJwUTTmJwQMuxJwJwueupypJwDNivJwsdDNJwueupypJwJwJwPwvspcvsvsUk
DNlqHRAyKBQzQzCbQzQzKRDNGxBCPQDNsdJwsdDNswBCTtJwDNOHPPnWuxJwJwswBCTtscDNsdJwsdDNJwswBCTtJwPwWcAKDNDNuxDNQX
GrDNsZsZsZLvfWsZsZsZsZDNypeIJwDNDNSlDNDNJwJwJwJwDNuxuxuxDNJwJwJwJwJwJwDNDNSlDNDNJwJwJwkkpcvTDNuxDNQXQXQXQX
QXDNqnadAguIQAAgyiadqnDNypJwJwJwJwJwJwJwJwJweIJwJwJwJwJwJwJwJwJwJwJwJwJwJwJwJwJwJwPwvsvTDNdnDNQXQXQXQXQXQX
QXDNDNGGInFnQAuIQsyiDNDNZwJwJwJwJwJwJwJwJwJwJwJwJwJweIJwJwJwJwJwJwJwJwJwJwJwJwJwPwvTuxuxDNQXQXQXQXQXQXQXQX
QXQXDNadjKuIpbjKRONODNPyTtJHvsvssovsvsJHvsJwsovsvsJHvsJwsovsvsJHvsvssoJwJwJHvsvsfbDNuxuxQXQXQXQXQXQXQXQXQX
QXQXLJDNadQAFnadDNDNLJJcuxDNdnuxDNdnuxDNdnFZDNdnuxDNdnNsDNdnuxDNdnuxDNdnFZDNdnuxDNDNDNQXQXQXQXQXQXQXQXQXQX
QXQXQXDNDNmyjVDNDNQXQXQXQXQXRPRPRPWrQXQXQXaKQXQXQXQXQXdQQXQXRPRPRPWrQXQXhLEUQXQXQXQXQXQXQXQXQXQXQXQXQXQXQX
QXQXQXQXDNLJDNDNQXQXQXQXQXQXQXWrRPWrQXQXQXcNQXQXQXQXQXcNQXQXQXWrRPWrQXQXQXcNQXQXQXQXQXQXQXQXQXQXQXQXQXQXQX
QXQXQXQXQXQXQXQXQXQXQXQXQXQXQXWrRPWrQXQXQXQXQXQXQXQXQXQXQXQXQXWrRPWrQXQXQXQXQXQXQXQXQXQXQXQXQXQXQXQXQXQXQX
QXQXQXQXQXQXQXQXQXQXQXQXQXQXQXWrRPWrQXQXQXQXQXQXQXQXQXQXQXQXQXWrRPWrQXQXQXQXQXQXQXQXQXQXQXQXQXQXQXQXQXQXQX
QXQXQXQXQXQXQXQXQXQXQXQXQXQXQXWrRPRPWrQXQXQXQXQXQXQXQXQXQXQXQXWrRPRPWrQXQXQXQXQXQXQXQXQXQXQXQXQXQXQXQXQXQX
QXQXQXQXQXQXQXQXQXQXQXQXQXQXQXWrRPRPRPWrQXQXQXQXQXQXQXQXQXQXQXWrRPRPRPWrQXQXQXQXQXQXQXQXQXQXQXQXQXQXQXQXQX
QXQXQXQXQXQXQXQXQXQXQXQXQXQXQXWrRPWrWrQXQXQXQXQXQXQXQXQXQXQXQXWrRPWrWrQXQXQXQXQXQXQXQXQXQXQXQXQXQXQXQXQXQX
QXQXQXQXQXQXQXQXQXQXQXQXQXQXQXWrRPWrQXQXQXQXQXQXQXQXQXQXQXQXQXWrRPWrQXQXQXQXQXQXQXQXQXQXQXQXQXQXQXQXQXQXQX
QXQXQXQXQXQXQXQXQXQXQXQXQXQXQXQXWrQXQXQXQXQXQXQXQXQXQXQXQXQXQXQXWrQXQXQXQXQXQXQXQXQXQXQXQXQXQXQXQXQXQXQXQX
"}
