"an" = (/turf/open/floor/wood,/area/shuttle/pirate)
"ap" = (/turf/open/floor/carpet/royalblack/airless,/area/shuttle/pirate)
"aF" = (/obj/item/flashlight/flare/candle/infinite,/turf/open/floor/stone,/area/shuttle/pirate)
"aI" = (/obj/effect/mapping_helpers/airlock/cutaiwire,/obj/machinery/door/airlock/cult/friendly{name = "Captains Quarters"},/obj/structure/fans/tiny/invisible,/turf/open/floor/carpet/red/airless,/area/shuttle/pirate)
"aT" = (/obj/effect/mob_spawn/ghost_role/human/pirate/skeleton,/obj/effect/turf_decal/siding/wood,/turf/open/floor/wood,/area/shuttle/pirate)
"aV" = (/obj/effect/turf_decal/siding/wood{dir = 1},/turf/open/floor/wood,/area/shuttle/pirate)
"bq" = (/obj/structure/railing,/obj/effect/turf_decal/siding/wood/end,/obj/structure/cannon,/turf/open/floor/plating/airless,/area/shuttle/pirate)
"bx" = (/obj/structure/rack,/obj/item/claymore/cutlass,/obj/item/claymore/cutlass{pixel_x = -4; pixel_y = 4},/obj/item/claymore/cutlass,/obj/effect/turf_decal/siding/wood{dir = 5},/turf/open/floor/wood,/area/shuttle/pirate)
"by" = (/obj/effect/mob_spawn/corpse/human,/turf/open/floor/carpet/red,/area/shuttle/pirate)
"cg" = (/obj/effect/turf_decal/siding/wood/end{dir = 1},/obj/structure/railing{dir = 1},/obj/structure/cannon{dir = 1},/turf/open/floor/plating/airless,/area/shuttle/pirate)
"cT" = (/obj/effect/turf_decal/siding/wood/corner,/turf/open/floor/wood/airless,/area/shuttle/pirate)
"dR" = (/obj/structure/rack{icon = 'icons/obj/stationobjs.dmi'; icon_state = "minibar"; name = "skeletal minibar"},/obj/item/reagent_containers/condiment/milk{pixel_x = -5},/obj/item/reagent_containers/condiment/milk{pixel_x = 5},/obj/effect/turf_decal/siding/wood/corner{dir = 8},/turf/open/floor/wood,/area/shuttle/pirate)
"ed" = (/obj/effect/mob_spawn/ghost_role/human/pirate/skeleton,/turf/open/floor/wood,/area/shuttle/pirate)
"ee" = (/obj/structure/festivus{anchored = 1; color = "#825427"; desc = "A sturdy pole designed to hold the vessel's solar sails in place."; name = "mast"; pixel_x = -16; pixel_y = 2},/turf/closed/wall/mineral/wood/nonmetal,/area/shuttle/pirate)
"ew" = (/obj/effect/turf_decal/siding/wood{dir = 8},/obj/machinery/light/small/directional/west,/turf/open/floor/wood/airless,/area/shuttle/pirate)
"ey" = (/obj/effect/turf_decal/siding/wood/end,/turf/closed/wall/mineral/wood/nonmetal,/area/shuttle/pirate)
"eH" = (/obj/effect/turf_decal/siding/wood/corner{dir = 1},/turf/open/floor/wood/airless,/area/shuttle/pirate)
"eZ" = (/obj/effect/turf_decal/siding/wood/corner,/obj/effect/mob_spawn/ghost_role/human/pirate/skeleton,/turf/open/floor/wood/airless,/area/shuttle/pirate)
"fr" = (/obj/item/kirbyplants/random/dead,/obj/machinery/light/small/directional/south,/turf/open/floor/stone,/area/shuttle/pirate)
"fx" = (/obj/structure/table/wood,/obj/machinery/recharger{pixel_y = 2},/obj/effect/turf_decal/siding/wood{dir = 1},/turf/open/floor/wood/airless,/area/shuttle/pirate)
"fY" = (/obj/effect/mapping_helpers/airlock/cutaiwire,/obj/machinery/door/airlock/vault{color = "#825427"; name = "Powder Storage"},/turf/open/floor/wood/airless,/area/shuttle/pirate)
"hf" = (/obj/structure/table/wood,/obj/item/stack/cannonball/fourteen,/obj/item/flashlight/flare/torch,/obj/machinery/light/small/directional/south,/obj/effect/turf_decal/siding/wood,/turf/open/floor/wood/airless,/area/shuttle/pirate)
"hs" = (/obj/effect/mob_spawn/ghost_role/human/pirate/skeleton,/turf/open/floor/wood/airless,/area/shuttle/pirate)
"hO" = (/obj/effect/turf_decal/siding/wood/corner,/turf/closed/wall/mineral/wood/nonmetal,/area/shuttle/pirate)
"hV" = (/obj/machinery/porta_turret/syndicate/energy{dir = 1; faction = list("pirate")},/turf/closed/wall/mineral/wood/nonmetal,/area/shuttle/pirate)
"hW" = (/obj/structure/closet/cabinet{name = "The red captains cabinet"},/obj/item/clothing/shoes/pirate/armored,/obj/item/clothing/under/syndicate/bloodred{name = "blood-red suit"},/obj/item/clothing/suit/hooded/berserker{pressure_resistance = 10; min_cold_protection_temperature = 0; name = "Red captains armor"; desc = "Voices of the lost echo from the armor, looted and passed down through millenia of combat"; resistance_flags = 3},/obj/item/tank/jetpack/oxygen/security{name = "red captains jetpack"; desc = "A tank of compressed oxygen fitted for the red captain"},/obj/item/bedsheet/hos{name = "Red captains cloak"},/obj/item/card/id/advanced/black{trim = /datum/id_trim/pirate/captain; name = "The red captain"},/obj/item/radio/headset/syndicate/alt/leader{name = "red captains headset"},/obj/item/implanter/storage,/turf/open/floor/stone,/area/shuttle/pirate)
"iC" = (/obj/machinery/computer/camera_advanced/shuttle_docker/syndicate/pirate{dir = 8; x_offset = -4; y_offset = -8},/turf/open/floor/carpet/royalblack/airless,/area/shuttle/pirate)
"iX" = (/obj/structure/rack{icon = 'icons/obj/stationobjs.dmi'; icon_state = "minibar"; name = "skeletal minibar"},/obj/item/reagent_containers/condiment/milk{pixel_x = -5},/obj/item/reagent_containers/condiment/milk{pixel_x = 5},/obj/effect/turf_decal/siding/wood{dir = 1},/turf/open/floor/wood,/area/shuttle/pirate)
"jo" = (/obj/machinery/light/small/directional/east,/obj/effect/turf_decal/siding/wood{dir = 4},/turf/open/floor/wood,/area/shuttle/pirate)
"jE" = (/mob/living/basic/cow,/obj/machinery/light/small/directional/west,/turf/open/floor/grass,/area/shuttle/pirate)
"jY" = (/turf/closed/wall/mineral/iron{name = "rough stone wall"; desc = "A wall with rough cobblestones forming a wall"},/area/shuttle/pirate)
"lm" = (/obj/machinery/light/small/directional/south,/obj/effect/turf_decal/siding/wood,/turf/open/floor/wood/airless,/area/shuttle/pirate)
"lR" = (/obj/structure/lattice/catwalk,/turf/open/space/basic,/area/shuttle/pirate)
"lZ" = (/obj/item/stack/sheet/mineral/wood/fifty,/obj/effect/mob_spawn/ghost_role/human/pirate/skeleton,/turf/open/floor/wood,/area/shuttle/pirate)
"mk" = (/obj/effect/decal/cleanable/blood,/obj/item/flashlight/flare/candle/infinite,/obj/machinery/light/small/directional/north,/turf/open/floor/stone,/area/shuttle/pirate)
"oi" = (/obj/machinery/door/airlock/vault{color = "#825427"; name = "Ship Armoury"},/obj/effect/mapping_helpers/airlock/cutaiwire,/obj/structure/fans/tiny/invisible,/turf/open/floor/wood/airless,/area/shuttle/pirate)
"pc" = (/obj/item/flashlight/flare/candle/infinite,/turf/open/floor/carpet/red,/area/shuttle/pirate)
"pg" = (/obj/effect/turf_decal/siding/wood/end{dir = 8},/turf/open/floor/wood/airless,/area/shuttle/pirate)
"pq" = (/obj/item/reagent_containers/cup/bucket/wooden,/obj/effect/turf_decal/siding/wood{dir = 9},/obj/structure/fans/tiny/invisible,/turf/open/floor/wood,/area/shuttle/pirate)
"pB" = (/mob/living/basic/cow,/turf/open/floor/grass,/area/shuttle/pirate)
"qg" = (/obj/structure/table/wood,/obj/item/stack/cannonball/fourteen,/obj/item/flashlight/flare/torch,/obj/effect/turf_decal/siding/wood{dir = 6},/turf/open/floor/wood/airless,/area/shuttle/pirate)
"qF" = (/obj/effect/turf_decal/siding/wood{dir = 4},/obj/machinery/light/small/directional/east,/obj/machinery/light/small/directional/west,/obj/machinery/light/small/directional/west,/turf/open/floor/wood/airless,/area/shuttle/pirate)
"ra" = (/obj/effect/mob_spawn/corpse/human,/turf/open/floor/stone,/area/shuttle/pirate)
"rh" = (/turf/open/space/basic,/area/template_noop)
"rj" = (/obj/item/stack/cannonball/emp,/obj/item/stack/cannonball/emp,/obj/item/stack/cannonball/emp{pixel_x = 8; pixel_y = 4},/obj/item/stack/cannonball/emp{pixel_y = -3; pixel_x = -1},/obj/item/stack/cannonball/emp{pixel_y = -5; pixel_x = 6},/obj/effect/turf_decal/siding/wood{dir = 9},/obj/machinery/light/small/directional/north,/obj/item/stack/cannonball/emp{pixel_y = -5; pixel_x = 6},/obj/item/stack/cannonball/emp{pixel_y = -5; pixel_x = 6},/obj/item/stack/cannonball/emp{pixel_y = -5; pixel_x = 6},/obj/item/stack/cannonball/emp{pixel_y = -5; pixel_x = 6},/obj/item/stack/cannonball/emp{pixel_y = -5; pixel_x = 6},/obj/item/stack/cannonball/emp{pixel_y = -5; pixel_x = 6},/obj/item/stack/cannonball/emp{pixel_y = -5; pixel_x = 6},/turf/open/floor/wood,/area/shuttle/pirate)
"ro" = (/obj/structure/window/reinforced/shuttle/survival_pod,/turf/open/floor/wood/airless,/area/shuttle/pirate)
"rA" = (/obj/structure/rack,/obj/item/claymore/cutlass{pixel_x = -4; pixel_y = 4},/obj/item/claymore/cutlass,/obj/item/claymore/cutlass,/obj/effect/turf_decal/siding/wood{dir = 5},/obj/item/claymore/cutlass,/obj/item/claymore/cutlass,/turf/open/floor/wood,/area/shuttle/pirate)
"se" = (/obj/structure/fermenting_barrel/gunpowder,/obj/item/reagent_containers/cup/bucket/wooden,/obj/item/reagent_containers/cup/bucket/wooden,/obj/machinery/light/small/directional/west,/turf/open/floor/wood/airless,/area/shuttle/pirate)
"sy" = (/obj/structure/table,/obj/machinery/light/small/directional/west,/turf/open/floor/carpet/royalblack/airless,/area/shuttle/pirate)
"sJ" = (/obj/structure/table/wood,/obj/item/stack/cannonball/fourteen,/obj/item/flashlight/flare/torch,/obj/effect/turf_decal/siding/wood{dir = 5},/turf/open/floor/wood/airless,/area/shuttle/pirate)
"tV" = (/obj/structure/fermenting_barrel/gunpowder,/obj/item/reagent_containers/cup/bucket/wooden,/obj/item/reagent_containers/cup/bucket/wooden,/obj/effect/turf_decal/siding/wood,/turf/open/floor/wood/airless,/area/shuttle/pirate)
"uu" = (/obj/machinery/porta_turret/syndicate/energy{dir = 8; faction = list("pirate")},/turf/closed/wall/mineral/wood/nonmetal,/area/shuttle/pirate)
"uv" = (/obj/machinery/porta_turret/syndicate/energy{faction = list("pirate")},/turf/closed/wall/mineral/wood/nonmetal,/area/shuttle/pirate)
"uJ" = (/obj/effect/turf_decal/siding/wood{dir = 4},/turf/open/floor/wood/airless,/area/shuttle/pirate)
"uS" = (/obj/machinery/turretid{icon_state = "control_kill"; lethal = 1; locked = 0; pixel_y = -24; req_access = null},/turf/open/floor/wood,/area/shuttle/pirate)
"wd" = (/obj/structure/rack{icon = 'icons/obj/stationobjs.dmi'; icon_state = "minibar"; name = "skeletal minibar"},/obj/item/reagent_containers/condiment/milk{pixel_x = 5},/obj/item/reagent_containers/condiment/milk{pixel_x = -5},/turf/open/floor/wood,/area/shuttle/pirate)
"wn" = (/turf/open/floor/stone,/area/shuttle/pirate)
"wp" = (/obj/item/reagent_containers/cup/bucket/wooden,/obj/effect/turf_decal/siding/wood{dir = 8},/obj/structure/fans/tiny/invisible,/turf/open/floor/wood,/area/shuttle/pirate)
"ww" = (/turf/closed/wall/mineral/wood/nonmetal,/area/shuttle/pirate)
"xx" = (/obj/effect/turf_decal/siding/wood,/obj/effect/turf_decal/siding/wood/corner{dir = 4},/turf/open/floor/wood,/area/shuttle/pirate)
"xY" = (/obj/effect/turf_decal/siding/wood,/turf/open/floor/wood/airless,/area/shuttle/pirate)
"yl" = (/obj/structure/railing{dir = 4},/mob/living/basic/cow,/turf/open/floor/grass,/area/shuttle/pirate)
"yn" = (/obj/structure/railing{color = "#4C3117"; dir = 1; name = "wooden railing"},/turf/open/floor/wood/airless,/area/shuttle/pirate)
"yz" = (/obj/effect/turf_decal/siding/wood{dir = 1},/turf/open/floor/wood/airless,/area/shuttle/pirate)
"zr" = (/obj/effect/mapping_helpers/airlock/cutaiwire,/obj/machinery/door/airlock/cult/friendly{name = "Captains Quarters"},/obj/structure/fans/tiny/invisible,/turf/open/floor/carpet/red,/area/shuttle/pirate)
"zt" = (/obj/structure/table/wood/fancy/black,/obj/item/vorpalscythe{name = "Headtaker"; force = 20; bonus_force_multiplier = 5; block_chance = 10; wound_bonus = 20; bare_wound_bonus = 25; desc = "The legendary scythe wielded by the red captain, decapitating foes with this weapon makes it significantly stronger"},/turf/open/floor/carpet/red,/area/shuttle/pirate)
"zH" = (/turf/open/floor/carpet/red,/area/shuttle/pirate)
"Ah" = (/obj/effect/turf_decal/siding/wood/corner{dir = 1},/turf/open/floor/wood,/area/shuttle/pirate)
"An" = (/obj/item/flashlight/flare/candle/infinite{pixel_x = 14; pixel_y = -8},/turf/open/floor/stone,/area/shuttle/pirate)
"AM" = (/obj/effect/decal/cleanable/blood,/obj/item/kirbyplants/random/dead,/obj/machinery/light/small/directional/south,/turf/open/floor/stone,/area/shuttle/pirate)
"Bc" = (/obj/effect/turf_decal/siding/wood,/turf/open/floor/wood,/area/shuttle/pirate)
"Bd" = (/obj/effect/turf_decal/siding/wood{dir = 5},/turf/open/floor/wood/airless,/area/shuttle/pirate)
"Bi" = (/obj/machinery/turretid{icon_state = "control_kill"; lethal = 1; locked = 0; pixel_y = -24; req_access = null},/turf/open/floor/wood/airless,/area/shuttle/pirate)
"Bj" = (/obj/machinery/light/small/directional/north,/obj/effect/turf_decal/siding/wood{dir = 1},/turf/open/floor/wood,/area/shuttle/pirate)
"Br" = (/obj/structure/railing{dir = 6},/obj/effect/turf_decal/siding/wood/end{dir = 4},/obj/structure/cannon{dir = 4},/turf/open/floor/plating/airless,/area/shuttle/pirate)
"Bt" = (/obj/machinery/light/small/directional/west,/obj/effect/turf_decal/siding/wood{dir = 8},/obj/effect/turf_decal/siding/wood/corner{dir = 4},/turf/open/floor/wood/airless,/area/shuttle/pirate)
"CI" = (/obj/item/stack/cannonball/the_big_one,/obj/effect/turf_decal/siding/wood/end{dir = 8},/turf/open/floor/wood,/area/shuttle/pirate)
"Da" = (/obj/effect/turf_decal/siding/wood{dir = 6},/turf/open/floor/wood/airless,/area/shuttle/pirate)
"Dt" = (/obj/effect/turf_decal/siding/wood/corner{dir = 4},/turf/open/floor/wood/airless,/area/shuttle/pirate)
"Du" = (/obj/machinery/light/small/directional/west,/obj/effect/turf_decal/siding/wood{dir = 8},/turf/open/floor/wood/airless,/area/shuttle/pirate)
"Dx" = (/obj/structure/railing{color = "#4C3117"; dir = 8; name = "wooden railing"},/obj/structure/railing/corner{color = "#4C3117"; dir = 4; name = "wooden railing"},/turf/open/floor/wood/airless,/area/shuttle/pirate)
"Eu" = (/obj/effect/mob_spawn/ghost_role/human/pirate/skeleton,/obj/effect/turf_decal/siding/wood{dir = 8},/turf/open/floor/wood/airless,/area/shuttle/pirate)
"Ex" = (/obj/structure/rack{icon = 'icons/obj/stationobjs.dmi'; icon_state = "minibar"; name = "skeletal minibar"},/obj/item/reagent_containers/condiment/milk{pixel_x = -5},/obj/item/reagent_containers/condiment/milk{pixel_x = 5},/obj/effect/turf_decal/siding/wood/corner{dir = 1},/turf/open/floor/wood,/area/shuttle/pirate)
"Ey" = (/turf/open/floor/wood/airless,/area/shuttle/pirate)
"Ez" = (/obj/structure/railing{dir = 1},/obj/effect/turf_decal/siding/wood/end,/obj/structure/cannon{dir = 1},/turf/open/floor/plating/airless,/area/shuttle/pirate)
"EL" = (/obj/effect/turf_decal/siding/wood{dir = 8},/obj/structure/closet/cabinet,/obj/item/restraints/legcuffs/bola,/obj/item/restraints/legcuffs/bola,/obj/item/restraints/legcuffs/bola,/obj/item/restraints/legcuffs/bola/tactical,/obj/item/restraints/legcuffs/bola/tactical,/obj/item/restraints/handcuffs/cable,/obj/item/restraints/handcuffs/cable,/obj/item/restraints/handcuffs/cable,/obj/item/restraints/handcuffs/cable,/turf/open/floor/wood,/area/shuttle/pirate)
"Fa" = (/obj/machinery/piratepad,/turf/open/floor/carpet/royalblack/airless,/area/shuttle/pirate)
"Ff" = (/obj/structure/fermenting_barrel/gunpowder,/obj/item/reagent_containers/cup/bucket/wooden,/obj/item/reagent_containers/cup/bucket/wooden,/obj/machinery/light/small/directional/east,/turf/open/floor/wood/airless,/area/shuttle/pirate)
"Fr" = (/obj/machinery/light/small/directional/north,/obj/effect/turf_decal/siding/wood{dir = 5},/turf/open/floor/wood/airless,/area/shuttle/pirate)
"FJ" = (/obj/machinery/door/airlock/vault{color = "#825427"; name = "Ye Olde Strong Door"},/obj/effect/mapping_helpers/airlock/cutaiwire,/obj/structure/fans/tiny/invisible,/turf/open/floor/wood/airless,/area/shuttle/pirate)
"FO" = (/obj/machinery/light/small/directional/south,/obj/effect/turf_decal/siding/wood{dir = 6},/turf/open/floor/wood/airless,/area/shuttle/pirate)
"Gg" = (/obj/machinery/light/small/directional/north,/obj/effect/turf_decal/siding/wood{dir = 1},/turf/open/floor/wood/airless,/area/shuttle/pirate)
"GT" = (/turf/open/floor/wood/airless{icon = 'icons/obj/stairs.dmi'; base_icon_state = null; icon_state = "stairs_wood"; dir = 4},/area/shuttle/pirate)
"Hs" = (/obj/structure/lattice/catwalk,/turf/closed/wall/mineral/wood/nonmetal,/area/shuttle/pirate)
"Jc" = (/obj/structure/closet/crate/coffin{pixel_y = 6; name = "The red captains coffin"},/obj/item/flashlight/flare/candle/infinite{pixel_x = -10; pixel_y = -9},/obj/item/flashlight/flare/candle/infinite{pixel_x = 14; pixel_y = -8},/obj/item/flashlight/flare/candle/infinite{pixel_x = -12; pixel_y = 15},/obj/item/flashlight/flare/candle/infinite{pixel_x = 10; pixel_y = 17},/mob/living/carbon/human/species/vampire{real_name = "The Red Captain"; faction = list("pirate"); name = "The Red Captain"; use_random_name = 0; name_override = "The Red Captain"},/turf/open/floor/carpet/red,/area/shuttle/pirate)
"Jo" = (/obj/effect/turf_decal/siding/wood/end,/obj/structure/railing{dir = 1},/obj/structure/cannon{dir = 1},/turf/open/floor/plating/airless,/area/shuttle/pirate)
"KV" = (/obj/structure/railing{color = "#4C3117"; dir = 8; name = "wooden railing"},/obj/structure/railing{color = "#4C3117"; dir = 8; name = "wooden railing"},/obj/structure/railing{color = "#4C3117"; dir = 4; name = "wooden railing"},/turf/open/floor/wood/airless,/area/shuttle/pirate)
"LW" = (/obj/effect/turf_decal/siding/wood/corner{dir = 8},/turf/open/floor/wood/airless,/area/shuttle/pirate)
"NX" = (/obj/structure/table/wood/fancy/black,/obj/item/gun/energy/beam_rifle{lefthand_file = icons/mob/inhands/weapons/melee_lefthand.dmi; righthand_file = icons/mob/inhands/weapons/melee_righthand.dmi; inhand_icon_state = powerfist; icon = 'icons/obj/device_syndie.dmi'; icon_state = "powerfist"; pixel_y = 5; pixel_x = 3; color = #669900; name = "Hand of the red captain"; desc = "A weapon of devestating potential looted from an experimental terran lab."; aiming_time_fire_threshold = 3; projectile_damage = 50},/obj/item/necromantic_stone,/turf/open/floor/carpet/red,/area/shuttle/pirate)
"Ol" = (/turf/open/floor/iron/solarpanel/airless,/area/shuttle/pirate)
"Oq" = (/obj/structure/rack,/obj/item/gun/energy/laser,/obj/item/gun/energy/laser{pixel_x = -3; pixel_y = 6},/obj/item/gun/energy/laser{pixel_y = 3},/obj/item/gun/energy/laser{pixel_y = 3},/obj/item/gun/energy/laser{pixel_y = 3},/obj/item/gun/energy/laser{pixel_y = 3},/obj/item/gun/energy/laser{pixel_y = 3},/obj/machinery/light/small/directional/north,/obj/effect/turf_decal/siding/wood{dir = 1},/turf/open/floor/wood,/area/shuttle/pirate)
"OT" = (/obj/machinery/computer/piratepad_control{dir = 8},/turf/open/floor/carpet/royalblack/airless,/area/shuttle/pirate)
"Pn" = (/obj/structure/table/wood,/obj/item/stack/cannonball/fourteen,/obj/item/flashlight/flare/torch,/obj/machinery/light/small/directional/north,/obj/effect/turf_decal/siding/wood{dir = 1},/turf/open/floor/wood/airless,/area/shuttle/pirate)
"Pp" = (/obj/structure/rack,/obj/item/gun/ballistic/shotgun/automatic/combat,/obj/item/gun/ballistic/shotgun/automatic/combat,/obj/item/storage/box/lethalshot,/obj/item/storage/box/lethalshot,/obj/effect/turf_decal/siding/wood{dir = 4},/turf/open/floor/wood,/area/shuttle/pirate)
"Pw" = (/obj/item/stack/cannonball/fourteen,/obj/structure/table/wood,/obj/item/flashlight/flare/torch,/turf/open/floor/wood/airless,/area/shuttle/pirate)
"PT" = (/obj/effect/turf_decal/siding/wood{dir = 4},/obj/machinery/light/small/directional/east,/turf/open/floor/wood/airless,/area/shuttle/pirate)
"Qh" = (/obj/effect/mapping_helpers/airlock/cutaiwire,/obj/machinery/door/airlock/vault{color = "#825427"; name = "Powder Storage"},/obj/effect/turf_decal/siding/wood/corner,/turf/open/floor/wood/airless,/area/shuttle/pirate)
"QP" = (/obj/effect/decal/cleanable/blood,/turf/open/floor/stone,/area/shuttle/pirate)
"QV" = (/obj/machinery/light/small/directional/west,/turf/open/floor/wood/airless,/area/shuttle/pirate)
"Rk" = (/obj/structure/rack,/obj/item/gun/energy/laser{pixel_y = 3},/obj/item/gun/energy/laser{pixel_x = -3; pixel_y = 6},/obj/item/gun/energy/laser,/obj/item/gun/energy/laser{pixel_y = 3},/obj/item/gun/energy/laser{pixel_y = 3},/obj/item/gun/energy/laser{pixel_y = 3},/obj/item/gun/energy/laser{pixel_y = 3},/obj/machinery/light/small/directional/north,/obj/effect/turf_decal/siding/wood{dir = 1},/turf/open/floor/wood,/area/shuttle/pirate)
"Rv" = (/obj/structure/table,/obj/machinery/light/small/directional/west,/obj/item/reagent_containers/cup/glass/bottle/whiskey{pixel_y = 8},/obj/item/reagent_containers/cup/glass{pixel_y = 8; pixel_x = -7},/obj/item/reagent_containers/cup/glass{pixel_y = 7; pixel_x = 8},/turf/open/floor/carpet/royalblack/airless,/area/shuttle/pirate)
"Rz" = (/obj/effect/turf_decal/siding/wood,/obj/effect/turf_decal/siding/wood/corner{dir = 1},/obj/item/stack/cannonball/fourteen,/turf/open/floor/wood,/area/shuttle/pirate)
"Sj" = (/obj/structure/rack,/obj/item/claymore/cutlass{pixel_x = -4; pixel_y = 4},/obj/item/claymore/cutlass,/obj/item/claymore/cutlass,/obj/item/claymore/cutlass,/obj/item/claymore/cutlass,/obj/machinery/light/small/directional/north,/turf/open/floor/wood,/area/shuttle/pirate)
"Ti" = (/obj/structure/railing{dir = 5},/obj/effect/turf_decal/siding/wood/end{dir = 4},/obj/structure/cannon{dir = 4},/turf/open/floor/plating/airless,/area/shuttle/pirate)
"TX" = (/obj/machinery/computer/shuttle/pirate{dir = 8},/turf/open/floor/carpet/royalblack/airless,/area/shuttle/pirate)
"Ue" = (/obj/item/kirbyplants/random/dead,/turf/open/floor/stone,/area/shuttle/pirate)
"Uz" = (/obj/structure/fermenting_barrel/gunpowder,/obj/item/reagent_containers/cup/bucket/wooden,/obj/item/reagent_containers/cup/bucket/wooden,/turf/open/floor/wood/airless,/area/shuttle/pirate)
"Vm" = (/obj/structure/table/wood,/obj/machinery/recharger{pixel_y = 2},/obj/effect/turf_decal/siding/wood,/turf/open/floor/wood/airless,/area/shuttle/pirate)
"Vo" = (/obj/effect/turf_decal/siding/wood{dir = 1},/obj/effect/turf_decal/siding/wood/corner{dir = 8},/turf/open/floor/wood/airless,/area/shuttle/pirate)
"Vt" = (/obj/structure/railing{color = "#4C3117"; dir = 8; name = "wooden railing"},/obj/structure/railing{color = "#4C3117"; dir = 4; name = "wooden railing"},/turf/open/floor/wood/airless,/area/shuttle/pirate)
"VA" = (/obj/effect/turf_decal/siding/wood/corner{dir = 4},/turf/open/floor/wood,/area/shuttle/pirate)
"We" = (/obj/effect/turf_decal/siding/wood/end,/obj/structure/railing,/obj/structure/cannon,/turf/open/floor/plating/airless,/area/shuttle/pirate)
"Wi" = (/obj/machinery/computer/monitor{dir = 8},/turf/open/floor/carpet/royalblack/airless,/area/shuttle/pirate)
"Wo" = (/obj/item/stack/sheet/mineral/wood/fifty,/turf/open/floor/wood,/area/shuttle/pirate)
"WB" = (/obj/structure/closet/crate/freezer/blood,/turf/open/floor/stone,/area/shuttle/pirate)
"WP" = (/obj/structure/railing{color = "#4C3117"; dir = 4; name = "wooden railing"},/obj/structure/railing{color = "#4C3117"; dir = 8; name = "wooden railing"},/turf/open/floor/wood/airless,/area/shuttle/pirate)
"XG" = (/obj/effect/decal/cleanable/blood,/turf/open/floor/carpet/red,/area/shuttle/pirate)
"Yd" = (/obj/structure/rack,/obj/item/gun/ballistic/shotgun/automatic/combat,/obj/item/gun/ballistic/shotgun/automatic/combat,/obj/item/storage/box/lethalshot,/obj/item/storage/box/lethalshot,/obj/effect/turf_decal/siding/wood/end{dir = 4},/turf/open/floor/wood,/area/shuttle/pirate)
"Yf" = (/obj/structure/fermenting_barrel/gunpowder,/obj/item/reagent_containers/cup/bucket/wooden,/obj/item/reagent_containers/cup/bucket/wooden,/obj/effect/turf_decal/siding/wood{dir = 1},/turf/open/floor/wood/airless,/area/shuttle/pirate)
"Yi" = (/obj/effect/turf_decal/siding/wood{dir = 8},/turf/open/floor/wood/airless,/area/shuttle/pirate)
"Zs" = (/obj/structure/lattice/catwalk,/obj/structure/railing{color = "#4C3117"; dir = 8; name = "wooden railing"},/turf/open/space/basic,/area/shuttle/pirate)
"ZA" = (/obj/structure/cannon,/turf/open/floor/wood,/area/shuttle/pirate)
"ZE" = (/obj/machinery/light/small/directional/east,/obj/effect/turf_decal/siding/wood{dir = 5},/turf/open/floor/wood,/area/shuttle/pirate)
"ZJ" = (/obj/item/stack/cannonball/shellball/fourteen,/obj/effect/turf_decal/siding/wood{dir = 9},/turf/open/floor/wood,/area/shuttle/pirate)
"ZW" = (/obj/structure/rack{icon = 'icons/obj/stationobjs.dmi'; icon_state = "minibar"; name = "skeletal minibar"},/obj/item/reagent_containers/condiment/milk{pixel_x = -5},/obj/item/reagent_containers/condiment/milk{pixel_x = 5},/turf/open/floor/wood,/area/shuttle/pirate)

(1,1,1) = {"
rhrhrhrhrhrhrhrhrhrhrhrhrhrhrhrhOlrhrhrhrhrhrhrhrhrhrhrhrhrhrhrhOlrhrhrhrhrhrhrhrhrhrhrhrhrhrhrhrhrhrhrhrh
rhrhrhrhrhrhrhrhrhrhrhrhrhrhrhOllROlrhrhrhrhrhrhrhrhrhrhrhrhrhOllROlrhrhrhrhrhrhrhrhrhrhrhrhrhrhrhrhrhrhrh
rhrhrhrhrhrhrhrhrhrhrhrhrhrhrhOllROlrhrhrhrhrhrhrhrhrhrhrhrhrhOllROlrhrhrhrhrhrhrhrhrhrhrhrhrhrhrhrhrhrhrh
rhrhrhrhrhrhrhrhrhrhrhrhrhrhrhOllROlOlrhrhrhrhrhrhrhrhrhrhrhrhOllROlOlrhrhrhrhrhrhrhrhrhrhrhrhrhrhrhrhrhrh
rhrhrhrhrhrhrhrhrhrhrhrhrhrhrhOllRlRlROlrhrhrhrhrhrhrhrhrhrhrhOllRlRlROlrhrhrhrhrhrhrhrhrhrhrhrhrhrhrhrhrh
rhrhrhrhrhrhrhrhrhrhrhrhrhrhrhOllRlROlrhrhrhrhrhrhrhrhrhrhrhrhOllRlROlrhrhrhrhrhrhrhrhrhrhrhrhrhrhrhrhrhrh
rhrhrhrhrhrhrhrhrhrhrhrhrhrhrhOllROlrhrhrhrhrhrhrhrhrhrhrhrhrhOllROlrhrhrhrhrhrhrhrhrhrhrhrhrhrhrhrhrhrhrh
rhrhrhrhwwhVwwwwrhrhrhrhrhrhrhOllROlrhrhrhEyrhrhrhrhrhrhrhrhrhOllROlrhrhrhrhrhrhrhrhrhrhrhrhrhrhrhrhrhrhrh
rhrhrhwwwwwwwwwwwwrhrhrhrhrhlRlRlROlrhrhrhWPrhrhrhrhrhrhrhrhZslRlROlrhrhrhrhrhrhrhrhrhrhrhrhrhrhrhrhrhrhrh
rhrhhVwwZJRkOqbxwwwwhVcgrowwEzVtHsEzrowwEzWPwwEzrowwEzrowwEzVtwwEzrowwEzroeyEzrowwwwwwrhrhrhrhrhrhrhrhrhrh
rhrhwwrjAhWolZVASjrAwwpgVofxyzEyPnyzyzfxyzEyPnyzyzfxyzyzPnyzEyfxyzyzPnyzyzfxyzyzFrwwrororhrhrhrhrhrhrhrhrh
rhwwwwELanZAZAananPpwwwwDuPwEyEyEyEyEyPwEyEyEyEyEyPwEyEyEyEyEyPwEyEyEyEyEyPwEyEyDtBdrorowwrhrhrhrhrhrhrhrh
rhwwCIRzBcaTBcBcanxxYdwwYihsEyEyEyEyEyEyEyEyEyEyEyEyEyEyEyEyEyhsEyEyEyEyEyEyEyEyEyEyyzBdwwJowwrhrhrhrhrhrh
uuwwwwwwwwwwwwwwoiwwwwwwYiEyEyhOwwQhhOwwEyEyEyEywwrororowwEyEyEyEyEyEywwwwfYwwwwEyEyEyDtGgBdwwrowwrhrhrhrh
wwjEylpqiXaVBjaVanaVZEwwDuxYdRwwUzEyUzwwcTxYLWEywwRvFaOTroEyEycTxYLWZWwwUzEyUzwwEycTxYLWEyDtYfsJwwwwrowwrh
wwpBylwpananananedananFJuJeeewwwseEyUzwwqFeeEuEyGTEyEyTXroEyEyPTeeewEywwUzEyFfwwQVuJeeYiEyEyEyDtyzGgyzyzTi
wwpBylwpedanedananananFJuJeeewwwUzEyFfwwuJeeYiEyGTBiEyiCroEyEyPTeeewEywwseEyUzwwEyuJeeYiEyEyEycTxYlmxYxYBr
wwjEylwpwdananuSananjowwBtyzExwwUzEyUzwwDtyzeHEywwsyapWiroEyEyDtyzeHZWwwUzEyUzwwEyDtyzeHEycTtVqgwwwwrowwrh
uuwwjYjYjYzraIjYjYjYjYwwYihsEywwwwfYwwwwEyEyEyEywwrororowwEyEyEyEyEyEywwwwfYwwwwEyEyEyeZlmDawwrowwrhrhrhrh
rhwwWBUemkXGzHmkwnUeWBwwYiEyEyEyEyEyEyEyEyEyhsEyEyEyEyEyEyEyEyEyEyEyEyEyEyEyEyEyEycTxYDawwbqwwrhrhrhrhrhrh
rhwwwwQPrapczHXGJcAnwwwwDuPwEyEyEyEyEyPwEyEyEyEyEyPwhsEyEyEyEyPwEyEyEyEyEyPwEyEycTDarorowwrhrhrhrhrhrhrhrh
rhrhwwUeaFXGbyaFAMhWwwpgeHVmxYxYhfxYxYVmxYEyhfxYxYVmxYEyhfxYxYVmxYxYhfEyEyVmxYxYFOwwrororhrhrhrhrhrhrhrhrh
rhrhuvwwfrNXztUewwwwuvWerowwbqrowwbqrowwbqWPwwbqrowwbqVtwwbqrowwbqrowwbqWPwwbqrowwwwwwrhrhrhrhrhrhrhrhrhrh
rhrhrhwwwwwwwwwwwwrhrhrhrhrhlRlRlROlrhrhrhWPrhrhrhrhrhKVrhrhlRlRlROlrhrhDxynrhrhrhrhrhrhrhrhrhrhrhrhrhrhrh
rhrhrhrhwwuvwwwwrhrhrhrhrhrhrhOllROlrhrhrhEyrhrhrhrhrhEyrhrhrhOllROlrhrhrhEyrhrhrhrhrhrhrhrhrhrhrhrhrhrhrh
rhrhrhrhrhrhrhrhrhrhrhrhrhrhrhOllROlrhrhrhrhrhrhrhrhrhrhrhrhrhOllROlrhrhrhrhrhrhrhrhrhrhrhrhrhrhrhrhrhrhrh
rhrhrhrhrhrhrhrhrhrhrhrhrhrhrhOllROlrhrhrhrhrhrhrhrhrhrhrhrhrhOllROlrhrhrhrhrhrhrhrhrhrhrhrhrhrhrhrhrhrhrh
rhrhrhrhrhrhrhrhrhrhrhrhrhrhrhOllRlROlrhrhrhrhrhrhrhrhrhrhrhrhOllRlROlrhrhrhrhrhrhrhrhrhrhrhrhrhrhrhrhrhrh
rhrhrhrhrhrhrhrhrhrhrhrhrhrhrhOllRlRlROlrhrhrhrhrhrhrhrhrhrhrhOllRlRlROlrhrhrhrhrhrhrhrhrhrhrhrhrhrhrhrhrh
rhrhrhrhrhrhrhrhrhrhrhrhrhrhrhOllROlOlrhrhrhrhrhrhrhrhrhrhrhrhOllROlOlrhrhrhrhrhrhrhrhrhrhrhrhrhrhrhrhrhrh
rhrhrhrhrhrhrhrhrhrhrhrhrhrhrhOllROlrhrhrhrhrhrhrhrhrhrhrhrhrhOllROlrhrhrhrhrhrhrhrhrhrhrhrhrhrhrhrhrhrhrh
rhrhrhrhrhrhrhrhrhrhrhrhrhrhrhrhOlrhrhrhrhrhrhrhrhrhrhrhrhrhrhrhOlrhrhrhrhrhrhrhrhrhrhrhrhrhrhrhrhrhrhrhrh
"}
