"aE" = (/obj/structure/railing{dir = 1},/obj/effect/turf_decal/siding/wood/end,/obj/structure/cannon{dir = 1},/turf/open/floor/plating/airless,/area/shuttle/pirate)
"bs" = (/obj/structure/table,/obj/machinery/light/small/directional/west,/turf/open/floor/carpet/royalblack/airless,/area/shuttle/pirate)
"cp" = (/obj/item/stack/sheet/mineral/wood/fifty,/turf/open/floor/wood,/area/shuttle/pirate)
"cD" = (/obj/structure/railing{color = "#4C3117"; dir = 1; name = "wooden railing"},/turf/open/floor/wood/airless,/area/shuttle/pirate)
"dd" = (/obj/effect/turf_decal/siding/wood{dir = 1},/obj/effect/turf_decal/siding/wood/corner{dir = 8},/turf/open/floor/wood/airless,/area/shuttle/pirate)
"df" = (/turf/open/floor/carpet/red,/area/shuttle/pirate)
"dp" = (/obj/structure/window/reinforced/shuttle/survival_pod,/turf/open/floor/wood/airless,/area/shuttle/pirate)
"dq" = (/obj/structure/closet/crate/coffin{pixel_y = 6; name = "The red captains coffin"},/obj/item/flashlight/flare/candle/infinite{pixel_x = -10; pixel_y = -9},/obj/item/flashlight/flare/candle/infinite{pixel_x = 14; pixel_y = -8},/obj/item/flashlight/flare/candle/infinite{pixel_x = -12; pixel_y = 15},/obj/item/flashlight/flare/candle/infinite{pixel_x = 10; pixel_y = 17},/mob/living/carbon/human/species/vampire{real_name = "The Red Captain"; faction = list("pirate"); name = "The Red Captain"; use_random_name = 0; name_override = "The Red Captain"},/turf/open/floor/carpet/red,/area/shuttle/pirate)
"dS" = (/obj/effect/mapping_helpers/airlock/cutaiwire,/obj/machinery/door/airlock/cult/friendly{name = "Captains Quarters"},/turf/open/floor/carpet/red/airless,/area/shuttle/pirate)
"dY" = (/obj/effect/turf_decal/siding/wood{dir = 1},/turf/open/floor/wood,/area/shuttle/pirate)
"fh" = (/obj/effect/turf_decal/siding/wood{dir = 4},/obj/machinery/light/small/directional/east,/obj/machinery/light/small/directional/west,/obj/machinery/light/small/directional/west,/turf/open/floor/wood/airless,/area/shuttle/pirate)
"fq" = (/obj/machinery/door/airlock/vault{color = "#825427"; name = "Ye Olde Strong Door"},/obj/effect/mapping_helpers/airlock/cutaiwire,/turf/open/floor/wood/airless,/area/shuttle/pirate)
"fE" = (/obj/item/reagent_containers/cup/bucket/wooden,/obj/effect/turf_decal/siding/wood{dir = 8},/turf/open/floor/wood,/area/shuttle/pirate)
"gc" = (/turf/closed/wall/mineral/iron{name = "rough stone wall"; desc = "A wall with rough cobblestones forming a wall"},/area/shuttle/pirate)
"gD" = (/obj/machinery/computer/shuttle/pirate{dir = 8},/turf/open/floor/carpet/royalblack/airless,/area/shuttle/pirate)
"gJ" = (/obj/effect/turf_decal/siding/wood{dir = 4},/obj/machinery/light/small/directional/east,/turf/open/floor/wood/airless,/area/shuttle/pirate)
"ii" = (/obj/structure/railing{color = "#4C3117"; dir = 8; name = "wooden railing"},/obj/structure/railing/corner{color = "#4C3117"; dir = 4; name = "wooden railing"},/turf/open/floor/wood/airless,/area/shuttle/pirate)
"ip" = (/obj/effect/turf_decal/siding/wood{dir = 8},/turf/open/floor/wood/airless,/area/shuttle/pirate)
"iu" = (/obj/effect/mob_spawn/ghost_role/human/pirate/skeleton,/obj/effect/turf_decal/siding/wood{dir = 8},/turf/open/floor/wood/airless,/area/shuttle/pirate)
"iD" = (/turf/open/floor/wood/airless,/area/shuttle/pirate)
"iQ" = (/obj/effect/turf_decal/siding/wood{dir = 9},/obj/structure/table/wood,/obj/item/stack/cannonball/fourteen,/obj/item/flashlight/flare/torch,/obj/effect/turf_decal/siding/wood{dir = 5},/turf/open/floor/wood/airless,/area/shuttle/pirate)
"iX" = (/obj/machinery/computer/monitor{dir = 8},/turf/open/floor/carpet/royalblack/airless,/area/shuttle/pirate)
"jx" = (/mob/living/basic/cow,/turf/open/floor/grass,/area/shuttle/pirate)
"jQ" = (/obj/effect/turf_decal/siding/wood/end{dir = 8},/turf/open/floor/wood/airless,/area/shuttle/pirate)
"jV" = (/obj/item/stack/sheet/mineral/wood/fifty,/obj/effect/mob_spawn/ghost_role/human/pirate/skeleton,/turf/open/floor/wood,/area/shuttle/pirate)
"kk" = (/obj/machinery/turretid{icon_state = "control_kill"; lethal = 1; locked = 0; pixel_y = -24; req_access = null},/turf/open/floor/wood,/area/shuttle/pirate)
"ku" = (/obj/structure/railing{dir = 4},/mob/living/basic/cow,/turf/open/floor/grass,/area/shuttle/pirate)
"kG" = (/obj/effect/turf_decal/siding/wood,/turf/open/floor/wood,/area/shuttle/pirate)
"kJ" = (/obj/effect/turf_decal/siding/wood/end,/obj/structure/railing{dir = 1},/obj/structure/cannon{dir = 1},/turf/open/floor/plating/airless,/area/shuttle/pirate)
"lU" = (/obj/effect/turf_decal/siding/wood/end,/obj/structure/railing,/obj/structure/cannon,/turf/open/floor/plating/airless,/area/shuttle/pirate)
"mh" = (/obj/effect/turf_decal/siding/wood{dir = 9},/obj/structure/table/wood,/obj/item/flashlight/flare/torch,/obj/machinery/recharger{pixel_y = 2},/obj/effect/turf_decal/siding/wood,/turf/open/floor/wood/airless,/area/shuttle/pirate)
"nf" = (/obj/item/kirbyplants/random/dead,/obj/machinery/light/small/directional/south,/turf/open/floor/stone,/area/shuttle/pirate)
"nl" = (/obj/effect/mob_spawn/corpse/human,/turf/open/floor/carpet/red,/area/shuttle/pirate)
"oa" = (/obj/machinery/light/small/directional/east,/obj/effect/turf_decal/siding/wood{dir = 4},/turf/open/floor/wood,/area/shuttle/pirate)
"oc" = (/obj/machinery/light/small/directional/west,/obj/effect/turf_decal/siding/wood{dir = 8},/obj/effect/turf_decal/siding/wood/corner{dir = 4},/turf/open/floor/wood/airless,/area/shuttle/pirate)
"oM" = (/obj/structure/table/wood/fancy/black,/obj/item/vorpalscythe{name = "Headtaker"; force = 20; bonus_force_multiplier = 5; block_chance = 10; wound_bonus = 20; bare_wound_bonus = 25; desc = "The legendary scythe wielded by the red captain, decapitating foes with this weapon makes it significantly stronger"},/turf/open/floor/carpet/red,/area/shuttle/pirate)
"oO" = (/obj/machinery/turretid{icon_state = "control_kill"; lethal = 1; locked = 0; pixel_y = -24; req_access = null},/turf/open/floor/wood/airless,/area/shuttle/pirate)
"oP" = (/obj/effect/turf_decal/siding/wood{dir = 9},/obj/structure/table/wood,/obj/item/stack/cannonball/fourteen,/obj/item/flashlight/flare/torch,/obj/machinery/light/small/directional/north,/obj/effect/turf_decal/siding/wood{dir = 1},/turf/open/floor/wood/airless,/area/shuttle/pirate)
"pC" = (/obj/effect/turf_decal/siding/wood/corner{dir = 1},/turf/open/floor/wood/airless,/area/shuttle/pirate)
"qd" = (/obj/item/stack/cannonball/fourteen,/turf/open/floor/wood/airless,/area/shuttle/pirate)
"qB" = (/obj/structure/cannon,/turf/open/floor/wood,/area/shuttle/pirate)
"qJ" = (/obj/effect/decal/cleanable/blood,/obj/item/kirbyplants/random/dead,/obj/machinery/light/small/directional/south,/turf/open/floor/stone,/area/shuttle/pirate)
"rw" = (/obj/structure/railing{color = "#4C3117"; dir = 4; name = "wooden railing"},/obj/structure/railing{color = "#4C3117"; dir = 8; name = "wooden railing"},/turf/open/floor/wood/airless,/area/shuttle/pirate)
"sl" = (/obj/machinery/light/small/directional/west,/obj/effect/turf_decal/siding/wood{dir = 8},/turf/open/floor/wood/airless,/area/shuttle/pirate)
"tm" = (/obj/structure/rack{icon = 'icons/obj/stationobjs.dmi'; icon_state = "minibar"; name = "skeletal minibar"},/obj/item/reagent_containers/condiment/milk{pixel_x = 5},/obj/item/reagent_containers/condiment/milk{pixel_x = -5},/turf/open/floor/wood,/area/shuttle/pirate)
"tP" = (/obj/effect/turf_decal/siding/wood{dir = 9},/obj/structure/table/wood,/obj/item/flashlight/flare/torch,/obj/machinery/recharger{pixel_y = 2},/obj/effect/turf_decal/siding/wood{dir = 1},/turf/open/floor/wood/airless,/area/shuttle/pirate)
"uh" = (/obj/structure/fermenting_barrel/gunpowder,/obj/item/reagent_containers/cup/bucket/wooden,/obj/item/reagent_containers/cup/bucket/wooden,/obj/effect/turf_decal/siding/wood,/turf/open/floor/wood/airless,/area/shuttle/pirate)
"ur" = (/obj/effect/mapping_helpers/airlock/cutaiwire,/obj/machinery/door/airlock/vault{color = "#825427"; name = "Powder Storage"},/turf/open/floor/wood/airless,/area/shuttle/pirate)
"ux" = (/obj/effect/turf_decal/siding/wood{dir = 8},/obj/structure/closet/cabinet,/obj/item/restraints/legcuffs/bola,/obj/item/restraints/legcuffs/bola,/obj/item/restraints/legcuffs/bola,/obj/item/restraints/legcuffs/bola/tactical,/obj/item/restraints/legcuffs/bola/tactical,/obj/item/restraints/handcuffs/cable,/obj/item/restraints/handcuffs/cable,/obj/item/restraints/handcuffs/cable,/obj/item/restraints/handcuffs/cable,/turf/open/floor/wood,/area/shuttle/pirate)
"uG" = (/obj/structure/rack,/obj/item/claymore/cutlass{pixel_x = -4; pixel_y = 4},/obj/item/claymore/cutlass,/obj/item/claymore/cutlass,/obj/effect/turf_decal/siding/wood{dir = 5},/obj/item/claymore/cutlass,/obj/item/claymore/cutlass,/turf/open/floor/wood,/area/shuttle/pirate)
"ve" = (/obj/structure/rack{icon = 'icons/obj/stationobjs.dmi'; icon_state = "minibar"; name = "skeletal minibar"},/obj/item/reagent_containers/condiment/milk{pixel_x = -5},/obj/item/reagent_containers/condiment/milk{pixel_x = 5},/obj/effect/turf_decal/siding/wood{dir = 1},/turf/open/floor/wood,/area/shuttle/pirate)
"vi" = (/obj/structure/railing{color = "#4C3117"; dir = 8; name = "wooden railing"},/obj/structure/railing{color = "#4C3117"; dir = 8; name = "wooden railing"},/obj/structure/railing{color = "#4C3117"; dir = 4; name = "wooden railing"},/turf/open/floor/wood/airless,/area/shuttle/pirate)
"vF" = (/obj/structure/lattice/catwalk,/turf/closed/wall/mineral/wood/nonmetal,/area/shuttle/pirate)
"vP" = (/obj/machinery/light/small/directional/north,/obj/effect/turf_decal/siding/wood{dir = 1},/turf/open/floor/wood,/area/shuttle/pirate)
"vX" = (/obj/structure/rack,/obj/item/gun/energy/laser,/obj/item/gun/energy/laser{pixel_x = -3; pixel_y = 6},/obj/item/gun/energy/laser{pixel_y = 3},/obj/item/gun/energy/laser{pixel_y = 3},/obj/item/gun/energy/laser{pixel_y = 3},/obj/item/gun/energy/laser{pixel_y = 3},/obj/item/gun/energy/laser{pixel_y = 3},/obj/effect/turf_decal/siding/wood{dir = 5},/obj/machinery/light/small/directional/north,/turf/open/floor/wood,/area/shuttle/pirate)
"wf" = (/obj/structure/rack{icon = 'icons/obj/stationobjs.dmi'; icon_state = "minibar"; name = "skeletal minibar"},/obj/item/reagent_containers/condiment/milk{pixel_x = -5},/obj/item/reagent_containers/condiment/milk{pixel_x = 5},/obj/effect/turf_decal/siding/wood/corner{dir = 8},/turf/open/floor/wood,/area/shuttle/pirate)
"wj" = (/obj/item/stack/cannonball/the_big_one,/obj/effect/turf_decal/siding/wood/end{dir = 8},/turf/open/floor/wood,/area/shuttle/pirate)
"wq" = (/obj/effect/turf_decal/siding/wood,/turf/open/floor/wood/airless,/area/shuttle/pirate)
"wD" = (/obj/structure/railing{dir = 6},/obj/effect/turf_decal/siding/wood/end{dir = 4},/obj/structure/cannon{dir = 4},/turf/open/floor/plating/airless,/area/shuttle/pirate)
"wY" = (/obj/structure/railing,/obj/effect/turf_decal/siding/wood/end,/obj/structure/cannon,/turf/open/floor/plating/airless,/area/shuttle/pirate)
"wZ" = (/obj/effect/turf_decal/siding/wood/corner{dir = 1},/turf/open/floor/wood,/area/shuttle/pirate)
"xm" = (/obj/effect/turf_decal/siding/wood/corner{dir = 8},/turf/open/floor/wood/airless,/area/shuttle/pirate)
"xo" = (/obj/structure/rack,/obj/item/gun/ballistic/shotgun/automatic/combat,/obj/item/gun/ballistic/shotgun/automatic/combat,/obj/item/storage/box/lethalshot,/obj/item/storage/box/lethalshot,/obj/effect/turf_decal/siding/wood{dir = 4},/turf/open/floor/wood,/area/shuttle/pirate)
"xu" = (/obj/structure/fermenting_barrel/gunpowder,/obj/item/reagent_containers/cup/bucket/wooden,/obj/item/reagent_containers/cup/bucket/wooden,/obj/effect/turf_decal/siding/wood{dir = 1},/turf/open/floor/wood/airless,/area/shuttle/pirate)
"xN" = (/obj/effect/mapping_helpers/airlock/cutaiwire,/obj/machinery/door/airlock/cult/friendly{name = "Captains Quarters"},/turf/open/floor/carpet/red,/area/shuttle/pirate)
"xO" = (/obj/machinery/light/small/directional/east,/obj/effect/turf_decal/siding/wood{dir = 5},/turf/open/floor/wood,/area/shuttle/pirate)
"yi" = (/obj/effect/turf_decal/siding/wood/corner{dir = 4},/turf/open/floor/wood/airless,/area/shuttle/pirate)
"yr" = (/obj/machinery/door/airlock/vault{color = "#825427"; name = "Ship Armoury"},/obj/effect/mapping_helpers/airlock/cutaiwire,/turf/open/floor/wood/airless,/area/shuttle/pirate)
"zi" = (/turf/open/floor/wood,/area/shuttle/pirate)
"zQ" = (/obj/machinery/computer/piratepad_control{dir = 8},/turf/open/floor/carpet/royalblack/airless,/area/shuttle/pirate)
"AI" = (/obj/structure/fermenting_barrel/gunpowder,/obj/item/reagent_containers/cup/bucket/wooden,/obj/item/reagent_containers/cup/bucket/wooden,/turf/open/floor/wood/airless,/area/shuttle/pirate)
"Bv" = (/obj/machinery/piratepad,/turf/open/floor/carpet/royalblack/airless,/area/shuttle/pirate)
"BF" = (/obj/structure/rack{icon = 'icons/obj/stationobjs.dmi'; icon_state = "minibar"; name = "skeletal minibar"},/obj/item/reagent_containers/condiment/milk{pixel_x = -5},/obj/item/reagent_containers/condiment/milk{pixel_x = 5},/turf/open/floor/wood,/area/shuttle/pirate)
"BO" = (/obj/machinery/porta_turret/syndicate/energy{dir = 8; faction = list("pirate")},/turf/closed/wall/mineral/wood/nonmetal,/area/shuttle/pirate)
"BX" = (/obj/structure/table,/obj/machinery/light/small/directional/west,/obj/item/reagent_containers/cup/glass/bottle/whiskey{pixel_y = 8},/obj/item/reagent_containers/cup/glass{pixel_y = 8; pixel_x = -7},/obj/item/reagent_containers/cup/glass{pixel_y = 7; pixel_x = 8},/turf/open/floor/carpet/royalblack/airless,/area/shuttle/pirate)
"Cv" = (/obj/structure/rack,/obj/item/claymore/cutlass,/obj/item/claymore/cutlass{pixel_x = -4; pixel_y = 4},/obj/item/claymore/cutlass,/obj/effect/turf_decal/siding/wood{dir = 5},/turf/open/floor/wood,/area/shuttle/pirate)
"CC" = (/obj/effect/turf_decal/siding/wood/corner,/turf/open/floor/wood/airless,/area/shuttle/pirate)
"CE" = (/obj/structure/lattice/catwalk,/obj/structure/railing{color = "#4C3117"; dir = 8; name = "wooden railing"},/turf/open/space/basic,/area/shuttle/pirate)
"CM" = (/obj/effect/turf_decal/siding/wood/corner,/turf/closed/wall/mineral/wood/nonmetal,/area/shuttle/pirate)
"CV" = (/obj/effect/turf_decal/siding/wood{dir = 1},/turf/open/floor/wood/airless,/area/shuttle/pirate)
"Dm" = (/obj/machinery/light/small/directional/north,/obj/effect/turf_decal/siding/wood{dir = 5},/turf/open/floor/wood/airless,/area/shuttle/pirate)
"Dy" = (/turf/open/floor/wood/airless{icon = 'icons/obj/stairs.dmi'; base_icon_state = null; icon_state = "stairs_wood"; dir = 4},/area/shuttle/pirate)
"Ed" = (/obj/effect/turf_decal/siding/wood/corner{dir = 4},/turf/open/floor/wood,/area/shuttle/pirate)
"Ef" = (/obj/effect/mob_spawn/ghost_role/human/pirate/skeleton,/turf/open/floor/wood/airless,/area/shuttle/pirate)
"Eg" = (/turf/open/space/basic,/area/template_noop)
"EN" = (/obj/structure/rack{icon = 'icons/obj/stationobjs.dmi'; icon_state = "minibar"; name = "skeletal minibar"},/obj/item/reagent_containers/condiment/milk{pixel_x = -5},/obj/item/reagent_containers/condiment/milk{pixel_x = 5},/obj/effect/turf_decal/siding/wood/corner{dir = 1},/turf/open/floor/wood,/area/shuttle/pirate)
"EU" = (/obj/effect/turf_decal/siding/wood,/obj/effect/turf_decal/siding/wood/corner{dir = 1},/obj/item/stack/cannonball/fourteen,/turf/open/floor/wood,/area/shuttle/pirate)
"FW" = (/obj/machinery/porta_turret/syndicate/energy{dir = 1; faction = list("pirate")},/turf/closed/wall/mineral/wood/nonmetal,/area/shuttle/pirate)
"Gl" = (/obj/machinery/porta_turret/syndicate/energy{faction = list("pirate")},/turf/closed/wall/mineral/wood/nonmetal,/area/shuttle/pirate)
"Gt" = (/obj/structure/railing{color = "#4C3117"; dir = 8; name = "wooden railing"},/obj/structure/railing{color = "#4C3117"; dir = 4; name = "wooden railing"},/turf/open/floor/wood/airless,/area/shuttle/pirate)
"Hr" = (/obj/machinery/light/small/directional/west,/turf/open/floor/wood/airless,/area/shuttle/pirate)
"HY" = (/mob/living/basic/cow,/obj/machinery/light/small/directional/west,/turf/open/floor/grass,/area/shuttle/pirate)
"Ig" = (/obj/item/flashlight/flare/candle/infinite{pixel_x = 14; pixel_y = -8},/turf/open/floor/stone,/area/shuttle/pirate)
"Ih" = (/obj/item/stack/cannonball/shellball/fourteen,/obj/effect/turf_decal/siding/wood{dir = 9},/turf/open/floor/wood,/area/shuttle/pirate)
"IW" = (/obj/effect/turf_decal/siding/wood{dir = 6},/turf/open/floor/wood/airless,/area/shuttle/pirate)
"IZ" = (/turf/open/floor/carpet/royalblack/airless,/area/shuttle/pirate)
"Jj" = (/obj/structure/rack,/obj/item/gun/energy/laser{pixel_y = 3},/obj/item/gun/energy/laser{pixel_x = -3; pixel_y = 6},/obj/item/gun/energy/laser,/obj/item/gun/energy/laser{pixel_y = 3},/obj/item/gun/energy/laser{pixel_y = 3},/obj/item/gun/energy/laser{pixel_y = 3},/obj/item/gun/energy/laser{pixel_y = 3},/obj/effect/turf_decal/siding/wood{dir = 9},/obj/machinery/light/small/directional/north,/turf/open/floor/wood,/area/shuttle/pirate)
"KA" = (/obj/effect/mob_spawn/corpse/human,/turf/open/floor/stone,/area/shuttle/pirate)
"KR" = (/obj/item/flashlight/flare/candle/infinite,/turf/open/floor/stone,/area/shuttle/pirate)
"KW" = (/obj/effect/turf_decal/siding/wood{dir = 4},/turf/open/floor/wood/airless,/area/shuttle/pirate)
"Nt" = (/obj/item/reagent_containers/cup/bucket/wooden,/obj/effect/turf_decal/siding/wood{dir = 9},/turf/open/floor/wood,/area/shuttle/pirate)
"NE" = (/obj/structure/railing{dir = 5},/obj/effect/turf_decal/siding/wood/end{dir = 4},/obj/structure/cannon{dir = 4},/turf/open/floor/plating/airless,/area/shuttle/pirate)
"NK" = (/obj/structure/festivus{anchored = 1; color = "#825427"; desc = "A sturdy pole designed to hold the vessel's solar sails in place."; name = "mast"; pixel_x = -16; pixel_y = 2},/turf/closed/wall/mineral/wood/nonmetal,/area/shuttle/pirate)
"NO" = (/obj/effect/decal/cleanable/blood,/turf/open/floor/stone,/area/shuttle/pirate)
"Ob" = (/obj/effect/mob_spawn/ghost_role/human/pirate/skeleton,/obj/effect/turf_decal/siding/wood,/turf/open/floor/wood,/area/shuttle/pirate)
"Oh" = (/obj/effect/mapping_helpers/airlock/cutaiwire,/obj/machinery/door/airlock/vault{color = "#825427"; name = "Powder Storage"},/obj/effect/turf_decal/siding/wood/corner,/turf/open/floor/wood/airless,/area/shuttle/pirate)
"Oy" = (/obj/structure/fermenting_barrel/gunpowder,/obj/item/reagent_containers/cup/bucket/wooden,/obj/item/reagent_containers/cup/bucket/wooden,/obj/machinery/light/small/directional/east,/turf/open/floor/wood/airless,/area/shuttle/pirate)
"OS" = (/obj/effect/turf_decal/siding/wood/corner,/obj/effect/mob_spawn/ghost_role/human/pirate/skeleton,/turf/open/floor/wood/airless,/area/shuttle/pirate)
"Pj" = (/obj/structure/table/wood/fancy/black,/obj/item/gun/energy/beam_rifle{lefthand_file = icons/mob/inhands/weapons/melee_lefthand.dmi; righthand_file = icons/mob/inhands/weapons/melee_righthand.dmi; inhand_icon_state = powerfist; icon = 'icons/obj/device_syndie.dmi'; icon_state = "powerfist"; pixel_y = 5; pixel_x = 3; color = #669900; name = "Hand of the red captain"; desc = "A weapon of devestating potential looted from an experimental terran lab."; aiming_time_fire_threshold = 3; projectile_damage = 50},/obj/item/necromantic_stone,/turf/open/floor/carpet/red,/area/shuttle/pirate)
"Pm" = (/obj/effect/mob_spawn/ghost_role/human/pirate/skeleton,/turf/open/floor/wood,/area/shuttle/pirate)
"Pn" = (/turf/open/floor/iron/solarpanel/airless,/area/shuttle/pirate)
"Qc" = (/obj/effect/turf_decal/siding/wood/end{dir = 1},/obj/structure/railing{dir = 1},/obj/structure/cannon{dir = 1},/turf/open/floor/plating/airless,/area/shuttle/pirate)
"QY" = (/obj/item/flashlight/flare/candle/infinite,/turf/open/floor/carpet/red,/area/shuttle/pirate)
"Rc" = (/obj/machinery/light/small/directional/south,/obj/effect/turf_decal/siding/wood,/turf/open/floor/wood/airless,/area/shuttle/pirate)
"Rz" = (/obj/machinery/light/small/directional/south,/obj/effect/turf_decal/siding/wood{dir = 6},/turf/open/floor/wood/airless,/area/shuttle/pirate)
"SA" = (/obj/effect/turf_decal/siding/wood{dir = 8},/obj/machinery/light/small/directional/west,/turf/open/floor/wood/airless,/area/shuttle/pirate)
"SM" = (/obj/item/kirbyplants/random/dead,/turf/open/floor/stone,/area/shuttle/pirate)
"SW" = (/obj/structure/lattice/catwalk,/turf/open/space/basic,/area/shuttle/pirate)
"Tt" = (/obj/item/stack/cannonball/emp,/obj/item/stack/cannonball/emp,/obj/item/stack/cannonball/emp{pixel_x = 8; pixel_y = 4},/obj/item/stack/cannonball/emp{pixel_y = -3; pixel_x = -1},/obj/item/stack/cannonball/emp{pixel_y = -5; pixel_x = 6},/obj/effect/turf_decal/siding/wood{dir = 9},/obj/machinery/light/small/directional/north,/obj/item/stack/cannonball/emp{pixel_y = -5; pixel_x = 6},/obj/item/stack/cannonball/emp{pixel_y = -5; pixel_x = 6},/obj/item/stack/cannonball/emp{pixel_y = -5; pixel_x = 6},/obj/item/stack/cannonball/emp{pixel_y = -5; pixel_x = 6},/obj/item/stack/cannonball/emp{pixel_y = -5; pixel_x = 6},/obj/item/stack/cannonball/emp{pixel_y = -5; pixel_x = 6},/obj/item/stack/cannonball/emp{pixel_y = -5; pixel_x = 6},/turf/open/floor/wood,/area/shuttle/pirate)
"Tv" = (/obj/effect/turf_decal/siding/wood{dir = 5},/turf/open/floor/wood/airless,/area/shuttle/pirate)
"Um" = (/obj/structure/fermenting_barrel/gunpowder,/obj/item/reagent_containers/cup/bucket/wooden,/obj/item/reagent_containers/cup/bucket/wooden,/obj/machinery/light/small/directional/west,/turf/open/floor/wood/airless,/area/shuttle/pirate)
"UE" = (/obj/effect/turf_decal/siding/wood,/obj/effect/turf_decal/siding/wood/corner{dir = 4},/turf/open/floor/wood,/area/shuttle/pirate)
"Vy" = (/obj/machinery/light/small/directional/north,/obj/effect/turf_decal/siding/wood{dir = 1},/turf/open/floor/wood/airless,/area/shuttle/pirate)
"VA" = (/obj/effect/decal/cleanable/blood,/obj/item/flashlight/flare/candle/infinite,/obj/machinery/light/small/directional/north,/turf/open/floor/stone,/area/shuttle/pirate)
"Wd" = (/obj/structure/rack,/obj/item/claymore/cutlass{pixel_x = -4; pixel_y = 4},/obj/item/claymore/cutlass,/obj/item/claymore/cutlass,/obj/item/claymore/cutlass,/obj/item/claymore/cutlass,/obj/machinery/light/small/directional/north,/turf/open/floor/wood,/area/shuttle/pirate)
"Wm" = (/obj/effect/turf_decal/siding/wood{dir = 9},/obj/structure/table/wood,/obj/item/stack/cannonball/fourteen,/obj/item/flashlight/flare/torch,/obj/effect/turf_decal/siding/wood{dir = 6},/turf/open/floor/wood/airless,/area/shuttle/pirate)
"Xf" = (/obj/machinery/computer/camera_advanced/shuttle_docker/syndicate/pirate{dir = 8; x_offset = -4; y_offset = -8},/turf/open/floor/carpet/royalblack/airless,/area/shuttle/pirate)
"Xl" = (/obj/effect/turf_decal/siding/wood/end,/turf/closed/wall/mineral/wood/nonmetal,/area/shuttle/pirate)
"XW" = (/obj/structure/rack,/obj/item/gun/ballistic/shotgun/automatic/combat,/obj/item/gun/ballistic/shotgun/automatic/combat,/obj/item/storage/box/lethalshot,/obj/item/storage/box/lethalshot,/obj/effect/turf_decal/siding/wood/end{dir = 4},/turf/open/floor/wood,/area/shuttle/pirate)
"Yo" = (/obj/effect/decal/cleanable/blood,/turf/open/floor/carpet/red,/area/shuttle/pirate)
"YH" = (/obj/structure/closet/cabinet{name = "The red captains cabinet"},/obj/item/clothing/shoes/pirate/armored,/obj/item/clothing/under/syndicate/bloodred{name = "blood-red suit"},/obj/item/clothing/suit/hooded/berserker{pressure_resistance = 10; min_cold_protection_temperature = 0; name = "Red captains armor"; desc = "Voices of the lost echo from the armor, looted and passed down through millenia of combat"; resistance_flags = 3},/obj/item/tank/jetpack/oxygen/security{name = "red captains jetpack"; desc = "A tank of compressed oxygen fitted for the red captain"},/obj/item/bedsheet/hos{name = "Red captains cloak"},/obj/item/card/id/advanced/black{trim = /datum/id_trim/pirate/captain; name = "The red captain"},/obj/item/radio/headset/syndicate/alt/leader{name = "red captains headset"},/obj/item/implanter/storage,/turf/open/floor/stone,/area/shuttle/pirate)
"YQ" = (/obj/structure/closet/crate/freezer/blood,/turf/open/floor/stone,/area/shuttle/pirate)
"Zl" = (/turf/closed/wall/mineral/wood/nonmetal,/area/shuttle/pirate)
"ZF" = (/obj/effect/turf_decal/siding/wood{dir = 9},/obj/structure/table/wood,/obj/item/stack/cannonball/fourteen,/obj/item/flashlight/flare/torch,/obj/machinery/light/small/directional/south,/obj/effect/turf_decal/siding/wood,/turf/open/floor/wood/airless,/area/shuttle/pirate)
"ZY" = (/turf/open/floor/stone,/area/shuttle/pirate)

(1,1,1) = {"
EgEgEgEgEgEgEgEgEgEgEgEgEgEgEgEgPnEgEgEgEgEgEgEgEgEgEgEgEgEgEgEgPnEgEgEgEgEgEgEgEgEgEgEgEgEgEgEgEgEgEgEgEg
EgEgEgEgEgEgEgEgEgEgEgEgEgEgEgPnSWPnEgEgEgEgEgEgEgEgEgEgEgEgEgPnSWPnEgEgEgEgEgEgEgEgEgEgEgEgEgEgEgEgEgEgEg
EgEgEgEgEgEgEgEgEgEgEgEgEgEgEgPnSWPnEgEgEgEgEgEgEgEgEgEgEgEgEgPnSWPnEgEgEgEgEgEgEgEgEgEgEgEgEgEgEgEgEgEgEg
EgEgEgEgEgEgEgEgEgEgEgEgEgEgEgPnSWPnPnEgEgEgEgEgEgEgEgEgEgEgEgPnSWPnPnEgEgEgEgEgEgEgEgEgEgEgEgEgEgEgEgEgEg
EgEgEgEgEgEgEgEgEgEgEgEgEgEgEgPnSWSWSWPnEgEgEgEgEgEgEgEgEgEgEgPnSWSWSWPnEgEgEgEgEgEgEgEgEgEgEgEgEgEgEgEgEg
EgEgEgEgEgEgEgEgEgEgEgEgEgEgEgPnSWSWPnEgEgEgEgEgEgEgEgEgEgEgEgPnSWSWPnEgEgEgEgEgEgEgEgEgEgEgEgEgEgEgEgEgEg
EgEgEgEgEgEgEgEgEgEgEgEgEgEgEgPnSWPnEgEgEgEgEgEgEgEgEgEgEgEgEgPnSWPnEgEgEgEgEgEgEgEgEgEgEgEgEgEgEgEgEgEgEg
EgEgEgEgZlFWZlZlEgEgEgEgEgEgEgPnSWPnEgEgEgiDEgEgEgEgEgEgEgEgEgPnSWPnEgEgEgEgEgEgEgEgEgEgEgEgEgEgEgEgEgEgEg
EgEgEgZlZlJjvXZlZlEgEgEgEgEgSWSWSWPnEgEgEgrwEgEgEgEgEgEgEgEgCESWSWPnEgEgEgEgEgEgEgEgEgEgEgEgEgEgEgEgEgEgEg
EgEgFWZlIhwZEdCvZlZlFWQcdpZlaEGtvFaEdpZlaErwZlaEdpZlaEdpZlaEGtZlaEdpZlaEdpXlaEdpZlZlZlEgEgEgEgEgEgEgEgEgEg
EgEgZlTtwZcpjVEdWduGZljQddtPCViDoPCVCVtPCViDoPCVCVtPCVCVoPCViDtPCVCVoPCVCVtPCVCVDmZldpdpEgEgEgEgEgEgEgEgEg
EgZlZluxziqBqBzizixoZlZlslqdiDiDiDiDiDqdiDiDiDiDiDqdiDiDiDiDiDqdiDiDiDiDiDqdiDiDyiTvdpdpZlEgEgEgEgEgEgEgEg
EgZlwjEUkGObkGkGziUEXWZlipEfiDiDiDiDiDiDiDiDiDiDiDiDiDiDiDiDiDEfiDiDiDiDiDiDiDiDiDiDCVTvZlkJZlEgEgEgEgEgEg
BOZlZlZlZlZlZlZlyrZlZlZlipiDiDCMZlOhCMZliDiDiDiDZldpdpdpZliDiDiDiDiDiDZlZlurZlZliDiDiDyiVyTvZldpZlEgEgEgEg
ZlHYkuNtvedYvPdYzidYxOZlslwqwfZlAIiDAIZlCCwqxmiDZlBXBvzQdpiDiDCCwqxmBFZlAIiDAIZliDCCwqxmiDyixuiQZlZldpZlEg
ZljxkufEziziziziPmzizifqKWNKSAZlUmiDAIZlfhNKiuiDDyiDiDgDdpiDiDgJNKSAiDZlAIiDOyZlHrKWNKipiDiDiDyiCVVyCVCVNE
ZljxkufEPmziPmzizizizifqKWNKSAZlAIiDOyZlKWNKipiDDyoOiDXfdpiDiDgJNKSAiDZlUmiDAIZliDKWNKipiDiDiDCCwqRcwqwqwD
ZlHYkufEtmzizikkzizioaZlocCVENZlAIiDAIZlyiCVpCiDZlbsIZiXdpiDiDyiCVpCBFZlAIiDAIZliDyiCVpCiDCCuhWmZlZldpZlEg
BOZlgcgcgcxNdSgcgcgcgcZlipEfiDZlZlurZlZliDiDiDiDZldpdpdpZliDiDiDiDiDiDZlZlurZlZliDiDiDOSRcIWZldpZlEgEgEgEg
EgZlYQSMVAYodfVAZYSMYQZlipiDiDiDiDiDiDiDiDiDEfiDiDiDiDiDiDiDiDiDiDiDiDiDiDiDiDiDiDCCwqIWZlwYZlEgEgEgEgEgEg
EgZlZlNOKAQYdfYodqIgZlZlslqdiDiDiDiDiDqdiDiDiDiDiDqdEfiDiDiDiDqdiDiDiDiDiDqdiDiDCCIWdpdpZlEgEgEgEgEgEgEgEg
EgEgZlSMKRYonlKRqJYHZljQpCmhwqwqZFwqwqmhwqiDZFwqwqmhwqiDZFwqwqmhwqwqZFiDiDmhwqwqRzZldpdpEgEgEgEgEgEgEgEgEg
EgEgGlZlnfdfQYSMZlZlGllUdpZlwYdpZlwYdpZlwYrwZlwYdpZlwYGtZlwYdpZlwYdpZlwYrwZlwYdpZlZlZlEgEgEgEgEgEgEgEgEgEg
EgEgEgZlZlPjoMZlZlEgEgEgEgEgSWSWSWPnEgEgEgrwEgEgEgEgEgviEgEgSWSWSWPnEgEgiicDEgEgEgEgEgEgEgEgEgEgEgEgEgEgEg
EgEgEgEgZlGlZlZlEgEgEgEgEgEgEgPnSWPnEgEgEgiDEgEgEgEgEgiDEgEgEgPnSWPnEgEgEgiDEgEgEgEgEgEgEgEgEgEgEgEgEgEgEg
EgEgEgEgEgEgEgEgEgEgEgEgEgEgEgPnSWPnEgEgEgEgEgEgEgEgEgEgEgEgEgPnSWPnEgEgEgEgEgEgEgEgEgEgEgEgEgEgEgEgEgEgEg
EgEgEgEgEgEgEgEgEgEgEgEgEgEgEgPnSWPnEgEgEgEgEgEgEgEgEgEgEgEgEgPnSWPnEgEgEgEgEgEgEgEgEgEgEgEgEgEgEgEgEgEgEg
EgEgEgEgEgEgEgEgEgEgEgEgEgEgEgPnSWSWPnEgEgEgEgEgEgEgEgEgEgEgEgPnSWSWPnEgEgEgEgEgEgEgEgEgEgEgEgEgEgEgEgEgEg
EgEgEgEgEgEgEgEgEgEgEgEgEgEgEgPnSWSWSWPnEgEgEgEgEgEgEgEgEgEgEgPnSWSWSWPnEgEgEgEgEgEgEgEgEgEgEgEgEgEgEgEgEg
EgEgEgEgEgEgEgEgEgEgEgEgEgEgEgPnSWPnPnEgEgEgEgEgEgEgEgEgEgEgEgPnSWPnPnEgEgEgEgEgEgEgEgEgEgEgEgEgEgEgEgEgEg
EgEgEgEgEgEgEgEgEgEgEgEgEgEgEgPnSWPnEgEgEgEgEgEgEgEgEgEgEgEgEgPnSWPnEgEgEgEgEgEgEgEgEgEgEgEgEgEgEgEgEgEgEg
EgEgEgEgEgEgEgEgEgEgEgEgEgEgEgEgPnEgEgEgEgEgEgEgEgEgEgEgEgEgEgEgPnEgEgEgEgEgEgEgEgEgEgEgEgEgEgEgEgEgEgEgEg
"}
