"ac" = (/turf/open/floor/carpet/royalblack/airless,/area/shuttle/pirate/flying_dutchman)
"ax" = (/obj/effect/turf_decal/siding/wood{dir = 4},/obj/machinery/light/small/directional/east,/turf/open/floor/wood/airless,/area/shuttle/pirate/flying_dutchman)
"aA" = (/obj/item/flashlight/flare/candle/infinite,/turf/open/floor/carpet/red,/area/shuttle/pirate/flying_dutchman)
"aE" = (/obj/effect/turf_decal/siding/wood,/obj/effect/turf_decal/siding/wood/corner{dir = 4},/turf/open/floor/wood,/area/shuttle/pirate/flying_dutchman)
"br" = (/obj/effect/turf_decal/siding/wood{dir = 9},/obj/structure/table/wood,/obj/item/stack/cannonball/fourteen,/obj/item/flashlight/flare/torch,/obj/machinery/light/small/directional/north,/obj/effect/turf_decal/siding/wood{dir = 1},/turf/open/floor/wood/airless,/area/shuttle/pirate/flying_dutchman)
"cg" = (/obj/item/stack/cannonball/emp,/obj/item/stack/cannonball/emp,/obj/item/stack/cannonball/emp{pixel_x = 8; pixel_y = 4},/obj/item/stack/cannonball/emp{pixel_y = -3; pixel_x = -1},/obj/item/stack/cannonball/emp{pixel_y = -5; pixel_x = 6},/obj/effect/turf_decal/siding/wood{dir = 9},/obj/machinery/light/small/directional/north,/obj/item/stack/cannonball/emp{pixel_y = -5; pixel_x = 6},/obj/item/stack/cannonball/emp{pixel_y = -5; pixel_x = 6},/obj/item/stack/cannonball/emp{pixel_y = -5; pixel_x = 6},/obj/item/stack/cannonball/emp{pixel_y = -5; pixel_x = 6},/obj/item/stack/cannonball/emp{pixel_y = -5; pixel_x = 6},/obj/item/stack/cannonball/emp{pixel_y = -5; pixel_x = 6},/obj/item/stack/cannonball/emp{pixel_y = -5; pixel_x = 6},/turf/open/floor/wood,/area/shuttle/pirate/flying_dutchman)
"cF" = (/obj/structure/closet/cabinet{name = "The red captains cabinet"},/obj/item/clothing/shoes/pirate/armored,/obj/item/clothing/under/syndicate/bloodred{name = "blood-red suit"},/obj/item/clothing/suit/hooded/berserker{pressure_resistance = 10; min_cold_protection_temperature = 0; name = "Red captains armor"; desc = "Voices of the lost echo from the armor, looted and passed down through millenia of combat"; resistance_flags = 3},/obj/item/tank/jetpack/oxygen/security{name = "red captains jetpack"; desc = "A tank of compressed oxygen fitted for the red captain"},/obj/item/bedsheet/hos{name = "Red captains cloak"},/obj/item/card/id/advanced/black{trim = /datum/id_trim/pirate/captain; name = "The red captain"},/obj/item/radio/headset/syndicate/alt/leader{name = "red captains headset"},/turf/open/floor/stone,/area/shuttle/pirate/flying_dutchman)
"dA" = (/obj/effect/mapping_helpers/airlock/cutaiwire,/obj/machinery/door/airlock/cult/friendly{name = "Captains Quarters"},/turf/open/floor/carpet/red,/area/shuttle/pirate/flying_dutchman)
"ej" = (/obj/structure/fermenting_barrel/gunpowder,/obj/item/reagent_containers/cup/bucket/wooden,/obj/item/reagent_containers/cup/bucket/wooden,/turf/open/floor/wood/airless,/area/shuttle/pirate/flying_dutchman)
"ek" = (/turf/open/floor/carpet/red,/area/shuttle/pirate/flying_dutchman)
"eu" = (/obj/item/reagent_containers/cup/bucket/wooden,/obj/effect/turf_decal/siding/wood{dir = 8},/turf/open/floor/wood,/area/shuttle/pirate/flying_dutchman)
"ey" = (/obj/machinery/door/airlock/vault{color = "#825427"; name = "Ye Olde Strong Door"},/obj/effect/mapping_helpers/airlock/cutaiwire,/turf/open/floor/wood/airless,/area/shuttle/pirate/flying_dutchman)
"eS" = (/turf/open/floor/wood,/area/shuttle/pirate/flying_dutchman)
"eY" = (/turf/closed/wall/mineral/iron{name = "rough stone wall"; desc = "A wall with rough cobblestones forming a wall"},/area/shuttle/pirate/flying_dutchman)
"fy" = (/obj/effect/turf_decal/siding/wood{dir = 9},/obj/structure/table/wood,/obj/item/stack/cannonball/fourteen,/obj/item/flashlight/flare/torch,/obj/machinery/recharger{pixel_y = 2},/obj/effect/turf_decal/siding/wood{dir = 1},/turf/open/floor/wood/airless,/area/shuttle/pirate/flying_dutchman)
"fD" = (/obj/effect/turf_decal/siding/wood{dir = 4},/turf/open/floor/wood/airless,/area/shuttle/pirate/flying_dutchman)
"fI" = (/obj/structure/rack,/obj/item/gun/ballistic/shotgun/automatic/combat,/obj/item/gun/ballistic/shotgun/automatic/combat,/obj/item/storage/box/lethalshot,/obj/item/storage/box/lethalshot,/obj/effect/turf_decal/siding/wood/end{dir = 4},/turf/open/floor/wood,/area/shuttle/pirate/flying_dutchman)
"gF" = (/obj/structure/closet/crate/coffin{pixel_y = 6; name = "The red captains coffin"},/obj/item/flashlight/flare/candle/infinite{pixel_x = -10; pixel_y = -9},/obj/item/flashlight/flare/candle/infinite{pixel_x = 14; pixel_y = -8},/obj/item/flashlight/flare/candle/infinite{pixel_x = -12; pixel_y = 15},/obj/item/flashlight/flare/candle/infinite{pixel_x = 10; pixel_y = 17},/mob/living/carbon/human/species/vampire{real_name = "The red captain"; faction = list("pirate")},/turf/open/floor/carpet/red,/area/shuttle/pirate/flying_dutchman)
"gX" = (/obj/structure/lattice/catwalk,/obj/structure/railing{color = "#4C3117"; dir = 8; name = "wooden railing"},/turf/open/space/basic,/area/shuttle/pirate/flying_dutchman)
"ha" = (/obj/structure/railing{dir = 6},/obj/effect/turf_decal/siding/wood/end{dir = 4},/obj/structure/cannon{dir = 4},/turf/open/floor/plating/airless,/area/shuttle/pirate/flying_dutchman)
"iV" = (/obj/structure/railing{color = "#4C3117"; dir = 4; name = "wooden railing"},/obj/structure/railing{color = "#4C3117"; dir = 8; name = "wooden railing"},/turf/open/floor/wood/airless,/area/shuttle/pirate/flying_dutchman)
"jr" = (/turf/open/floor/stone,/area/shuttle/pirate/flying_dutchman)
"jK" = (/obj/structure/rack{icon = 'icons/obj/stationobjs.dmi'; icon_state = "minibar"; name = "skeletal minibar"},/obj/item/reagent_containers/condiment/milk{pixel_x = -5},/obj/item/reagent_containers/condiment/milk{pixel_x = 5},/obj/effect/turf_decal/siding/wood/corner{dir = 1},/turf/open/floor/wood,/area/shuttle/pirate/flying_dutchman)
"ky" = (/obj/machinery/light/small/directional/south,/obj/effect/turf_decal/siding/wood{dir = 6},/turf/open/floor/wood/airless,/area/shuttle/pirate/flying_dutchman)
"ld" = (/turf/open/space/basic,/area/template_noop)
"lq" = (/obj/machinery/light/small/directional/north,/obj/effect/turf_decal/siding/wood{dir = 5},/turf/open/floor/wood/airless,/area/shuttle/pirate/flying_dutchman)
"lD" = (/obj/effect/mob_spawn/corpse/human,/turf/open/floor/carpet/red,/area/shuttle/pirate/flying_dutchman)
"mk" = (/obj/effect/mob_spawn/ghost_role/human/pirate/skeleton,/turf/open/floor/wood,/area/shuttle/pirate/flying_dutchman)
"mr" = (/obj/structure/fermenting_barrel/gunpowder,/obj/item/reagent_containers/cup/bucket/wooden,/obj/item/reagent_containers/cup/bucket/wooden,/obj/machinery/light/small/directional/west,/turf/open/floor/wood/airless,/area/shuttle/pirate/flying_dutchman)
"mA" = (/obj/machinery/computer/piratepad_control{dir = 8},/turf/open/floor/carpet/royalblack/airless,/area/shuttle/pirate/flying_dutchman)
"nM" = (/obj/structure/railing{dir = 1},/obj/effect/turf_decal/siding/wood/end,/obj/structure/cannon{dir = 1},/turf/open/floor/plating/airless,/area/shuttle/pirate/flying_dutchman)
"oI" = (/obj/structure/table/wood/fancy/black,/obj/item/vorpalscythe{name = "Headtaker"; force = 20; bonus_force_multiplier = 5; block_chance = 10; wound_bonus = 20; bare_wound_bonus = 25; desc = "The legendary scythe wielded by the red captain, decapitating foes with this weapon makes it significantly stronger"},/turf/open/floor/carpet/red,/area/shuttle/pirate/flying_dutchman)
"oP" = (/obj/structure/cannon,/turf/open/floor/wood,/area/shuttle/pirate/flying_dutchman)
"oV" = (/obj/effect/turf_decal/siding/wood{dir = 8},/obj/machinery/light/small/directional/west,/turf/open/floor/wood/airless,/area/shuttle/pirate/flying_dutchman)
"pi" = (/obj/effect/turf_decal/siding/wood/corner{dir = 8},/turf/open/floor/wood/airless,/area/shuttle/pirate/flying_dutchman)
"pB" = (/turf/open/floor/iron/solarpanel/airless,/area/shuttle/pirate/flying_dutchman)
"pK" = (/obj/item/stack/cannonball/the_big_one,/obj/effect/turf_decal/siding/wood/end{dir = 8},/turf/open/floor/wood,/area/shuttle/pirate/flying_dutchman)
"qx" = (/obj/machinery/light/small/directional/north,/obj/effect/turf_decal/siding/wood{dir = 1},/turf/open/floor/wood/airless,/area/shuttle/pirate/flying_dutchman)
"qI" = (/obj/structure/railing,/obj/effect/turf_decal/siding/wood/end,/obj/structure/cannon,/turf/open/floor/plating/airless,/area/shuttle/pirate/flying_dutchman)
"rw" = (/obj/structure/lattice/catwalk,/turf/open/space/basic,/area/shuttle/pirate/flying_dutchman)
"rZ" = (/obj/item/reagent_containers/cup/bucket/wooden,/obj/effect/turf_decal/siding/wood{dir = 9},/turf/open/floor/wood,/area/shuttle/pirate/flying_dutchman)
"tq" = (/obj/machinery/turretid{icon_state = "control_kill"; lethal = 1; locked = 0; pixel_y = -24; req_access = null},/turf/open/floor/wood/airless,/area/shuttle/pirate/flying_dutchman)
"tu" = (/obj/effect/turf_decal/siding/wood/end,/turf/closed/wall/mineral/wood/nonmetal,/area/shuttle/pirate/flying_dutchman)
"tw" = (/obj/machinery/light/small/directional/west,/turf/open/floor/wood/airless,/area/shuttle/pirate/flying_dutchman)
"tx" = (/obj/effect/decal/cleanable/blood,/turf/open/floor/carpet/red,/area/shuttle/pirate/flying_dutchman)
"uz" = (/obj/effect/turf_decal/siding/wood/corner,/turf/closed/wall/mineral/wood/nonmetal,/area/shuttle/pirate/flying_dutchman)
"uO" = (/obj/machinery/light/small/directional/east,/obj/effect/turf_decal/siding/wood{dir = 4},/turf/open/floor/wood,/area/shuttle/pirate/flying_dutchman)
"vf" = (/obj/structure/closet/crate/freezer/blood,/turf/open/floor/stone,/area/shuttle/pirate/flying_dutchman)
"vo" = (/obj/item/stack/sheet/mineral/wood/fifty,/turf/open/floor/wood,/area/shuttle/pirate/flying_dutchman)
"vB" = (/obj/structure/railing{dir = 5},/obj/effect/turf_decal/siding/wood/end{dir = 4},/obj/structure/cannon{dir = 4},/turf/open/floor/plating/airless,/area/shuttle/pirate/flying_dutchman)
"ww" = (/obj/structure/railing{color = "#4C3117"; dir = 8; name = "wooden railing"},/obj/structure/railing{color = "#4C3117"; dir = 4; name = "wooden railing"},/turf/open/floor/wood/airless,/area/shuttle/pirate/flying_dutchman)
"wQ" = (/obj/effect/turf_decal/siding/wood/end,/obj/structure/railing,/obj/structure/cannon,/turf/open/floor/plating/airless,/area/shuttle/pirate/flying_dutchman)
"xo" = (/obj/structure/rack{icon = 'icons/obj/stationobjs.dmi'; icon_state = "minibar"; name = "skeletal minibar"},/obj/item/reagent_containers/condiment/milk{pixel_x = -5},/obj/item/reagent_containers/condiment/milk{pixel_x = 5},/obj/effect/turf_decal/siding/wood{dir = 1},/turf/open/floor/wood,/area/shuttle/pirate/flying_dutchman)
"xW" = (/obj/structure/festivus{anchored = 1; color = "#825427"; desc = "A sturdy pole designed to hold the vessel's solar sails in place."; name = "mast"; pixel_x = -16; pixel_y = 2},/turf/closed/wall/mineral/wood/nonmetal,/area/shuttle/pirate/flying_dutchman)
"yk" = (/obj/structure/table/wood/fancy/black,/obj/item/gun/energy/beam_rifle{lefthand_file = icons/mob/inhands/weapons/melee_lefthand.dmi; righthand_file = icons/mob/inhands/weapons/melee_righthand.dmi; inhand_icon_state = powerfist; icon = 'icons/obj/device_syndie.dmi'; icon_state = "powerfist"; pixel_y = 5; pixel_x = 3; color = #669900; name = "Hand of the red captain"; desc = "A weapon of devestating potential looted from an experimental terran lab."; aiming_time_fire_threshold = 3; projectile_damage = 50},/obj/item/necromantic_stone,/turf/open/floor/carpet/red,/area/shuttle/pirate/flying_dutchman)
"yo" = (/obj/machinery/light/small/directional/south,/obj/effect/turf_decal/siding/wood,/turf/open/floor/wood/airless,/area/shuttle/pirate/flying_dutchman)
"yQ" = (/obj/structure/fermenting_barrel/gunpowder,/obj/item/reagent_containers/cup/bucket/wooden,/obj/item/reagent_containers/cup/bucket/wooden,/obj/effect/turf_decal/siding/wood,/turf/open/floor/wood/airless,/area/shuttle/pirate/flying_dutchman)
"yT" = (/obj/effect/turf_decal/siding/wood{dir = 8},/turf/open/floor/wood/airless,/area/shuttle/pirate/flying_dutchman)
"zy" = (/obj/effect/turf_decal/siding/wood{dir = 9},/obj/structure/table/wood,/obj/item/stack/cannonball/fourteen,/obj/item/flashlight/flare/torch,/obj/effect/turf_decal/siding/wood{dir = 6},/turf/open/floor/wood/airless,/area/shuttle/pirate/flying_dutchman)
"zM" = (/obj/machinery/door/airlock/vault{color = "#825427"; name = "Ship Armoury"},/obj/effect/mapping_helpers/airlock/cutaiwire,/turf/open/floor/wood/airless,/area/shuttle/pirate/flying_dutchman)
"zQ" = (/obj/machinery/porta_turret/syndicate/energy{faction = list("pirate")},/turf/closed/wall/mineral/wood/nonmetal,/area/shuttle/pirate/flying_dutchman)
"Ay" = (/obj/structure/railing{color = "#4C3117"; dir = 8; name = "wooden railing"},/obj/structure/railing{color = "#4C3117"; dir = 8; name = "wooden railing"},/obj/structure/railing{color = "#4C3117"; dir = 4; name = "wooden railing"},/turf/open/floor/wood/airless,/area/shuttle/pirate/flying_dutchman)
"AK" = (/obj/effect/turf_decal/siding/wood/end{dir = 1},/obj/structure/railing{dir = 1},/obj/structure/cannon{dir = 1},/turf/open/floor/plating/airless,/area/shuttle/pirate/flying_dutchman)
"BW" = (/obj/effect/mapping_helpers/airlock/cutaiwire,/obj/machinery/door/airlock/vault{color = "#825427"; name = "Powder Storage"},/obj/effect/turf_decal/siding/wood/corner,/turf/open/floor/wood/airless,/area/shuttle/pirate/flying_dutchman)
"Cq" = (/obj/effect/mapping_helpers/airlock/cutaiwire,/obj/machinery/door/airlock/cult/friendly{name = "Captains Quarters"},/turf/open/floor/carpet/red/airless,/area/shuttle/pirate/flying_dutchman)
"Cs" = (/obj/structure/rack,/obj/item/claymore/cutlass{pixel_x = -4; pixel_y = 4},/obj/item/claymore/cutlass,/obj/item/claymore/cutlass,/obj/effect/turf_decal/siding/wood{dir = 5},/obj/item/claymore/cutlass,/obj/item/claymore/cutlass,/turf/open/floor/wood,/area/shuttle/pirate/flying_dutchman)
"CG" = (/mob/living/basic/cow,/obj/machinery/light/small/directional/west,/turf/open/floor/grass,/area/shuttle/pirate/flying_dutchman)
"Dr" = (/obj/structure/rack{icon = 'icons/obj/stationobjs.dmi'; icon_state = "minibar"; name = "skeletal minibar"},/obj/item/reagent_containers/condiment/milk{pixel_x = 5},/obj/item/reagent_containers/condiment/milk{pixel_x = -5},/turf/open/floor/wood,/area/shuttle/pirate/flying_dutchman)
"DX" = (/obj/machinery/light/small/directional/west,/obj/effect/turf_decal/siding/wood{dir = 8},/obj/effect/turf_decal/siding/wood/corner{dir = 4},/turf/open/floor/wood/airless,/area/shuttle/pirate/flying_dutchman)
"Eb" = (/obj/item/stack/sheet/mineral/wood/fifty,/obj/effect/mob_spawn/ghost_role/human/pirate/skeleton,/turf/open/floor/wood,/area/shuttle/pirate/flying_dutchman)
"EH" = (/obj/effect/turf_decal/siding/wood{dir = 6},/turf/open/floor/wood/airless,/area/shuttle/pirate/flying_dutchman)
"ER" = (/obj/structure/table,/obj/machinery/light/small/directional/west,/obj/item/reagent_containers/cup/glass/bottle/whiskey{pixel_y = 8},/obj/item/reagent_containers/cup/glass{pixel_y = 8; pixel_x = -7},/obj/item/reagent_containers/cup/glass{pixel_y = 7; pixel_x = 8},/turf/open/floor/carpet/royalblack/airless,/area/shuttle/pirate/flying_dutchman)
"ET" = (/obj/structure/rack,/obj/item/claymore/cutlass,/obj/item/claymore/cutlass{pixel_x = -4; pixel_y = 4},/obj/item/claymore/cutlass,/obj/effect/turf_decal/siding/wood{dir = 5},/turf/open/floor/wood,/area/shuttle/pirate/flying_dutchman)
"EW" = (/obj/effect/turf_decal/siding/wood{dir = 9},/obj/structure/table/wood,/obj/item/stack/cannonball/fourteen,/obj/item/flashlight/flare/torch,/obj/machinery/light/small/directional/south,/obj/effect/turf_decal/siding/wood,/turf/open/floor/wood/airless,/area/shuttle/pirate/flying_dutchman)
"Fo" = (/turf/closed/wall/mineral/wood/nonmetal,/area/shuttle/pirate/flying_dutchman)
"FD" = (/mob/living/basic/cow,/turf/open/floor/grass,/area/shuttle/pirate/flying_dutchman)
"FE" = (/obj/effect/turf_decal/siding/wood,/turf/open/floor/wood,/area/shuttle/pirate/flying_dutchman)
"FN" = (/obj/effect/turf_decal/siding/wood/corner{dir = 4},/turf/open/floor/wood,/area/shuttle/pirate/flying_dutchman)
"Gb" = (/obj/effect/decal/cleanable/blood,/obj/item/flashlight/flare/candle/infinite,/obj/machinery/light/small/directional/north,/turf/open/floor/stone,/area/shuttle/pirate/flying_dutchman)
"Gg" = (/obj/machinery/porta_turret/syndicate/energy{dir = 1; faction = list("pirate")},/turf/closed/wall/mineral/wood/nonmetal,/area/shuttle/pirate/flying_dutchman)
"HD" = (/obj/effect/turf_decal/siding/wood{dir = 1},/obj/effect/turf_decal/siding/wood/corner{dir = 8},/turf/open/floor/wood/airless,/area/shuttle/pirate/flying_dutchman)
"HN" = (/obj/item/flashlight/flare/candle/infinite,/turf/open/floor/stone,/area/shuttle/pirate/flying_dutchman)
"HT" = (/obj/structure/table,/obj/machinery/light/small/directional/west,/turf/open/floor/carpet/royalblack/airless,/area/shuttle/pirate/flying_dutchman)
"HU" = (/obj/structure/rack,/obj/item/claymore/cutlass{pixel_x = -4; pixel_y = 4},/obj/item/claymore/cutlass,/obj/item/claymore/cutlass,/obj/item/claymore/cutlass,/obj/item/claymore/cutlass,/obj/machinery/light/small/directional/north,/turf/open/floor/wood,/area/shuttle/pirate/flying_dutchman)
"Id" = (/obj/structure/railing{color = "#4C3117"; dir = 8; name = "wooden railing"},/obj/structure/railing/corner{color = "#4C3117"; dir = 4; name = "wooden railing"},/turf/open/floor/wood/airless,/area/shuttle/pirate/flying_dutchman)
"IU" = (/obj/machinery/turretid{icon_state = "control_kill"; lethal = 1; locked = 0; pixel_y = -24; req_access = null},/turf/open/floor/wood,/area/shuttle/pirate/flying_dutchman)
"JG" = (/obj/effect/turf_decal/siding/wood,/turf/open/floor/wood/airless,/area/shuttle/pirate/flying_dutchman)
"JW" = (/obj/structure/rack,/obj/item/gun/energy/laser{pixel_y = 3},/obj/item/gun/energy/laser{pixel_x = -3; pixel_y = 6},/obj/item/gun/energy/laser,/obj/item/gun/energy/laser{pixel_y = 3},/obj/item/gun/energy/laser{pixel_y = 3},/obj/item/gun/energy/laser{pixel_y = 3},/obj/item/gun/energy/laser{pixel_y = 3},/obj/effect/turf_decal/siding/wood{dir = 9},/obj/machinery/light/small/directional/north,/turf/open/floor/wood,/area/shuttle/pirate/flying_dutchman)
"Kg" = (/obj/effect/turf_decal/siding/wood/corner{dir = 1},/turf/open/floor/wood/airless,/area/shuttle/pirate/flying_dutchman)
"Kl" = (/obj/effect/turf_decal/siding/wood{dir = 8},/obj/structure/closet/cabinet,/obj/item/restraints/legcuffs/bola,/obj/item/restraints/legcuffs/bola,/obj/item/restraints/legcuffs/bola,/obj/item/restraints/legcuffs/bola/tactical,/obj/item/restraints/legcuffs/bola/tactical,/obj/item/restraints/handcuffs/cable,/obj/item/restraints/handcuffs/cable,/obj/item/restraints/handcuffs/cable,/obj/item/restraints/handcuffs/cable,/turf/open/floor/wood,/area/shuttle/pirate/flying_dutchman)
"KA" = (/obj/effect/turf_decal/siding/wood/corner{dir = 1},/turf/open/floor/wood,/area/shuttle/pirate/flying_dutchman)
"Lo" = (/obj/structure/rack{icon = 'icons/obj/stationobjs.dmi'; icon_state = "minibar"; name = "skeletal minibar"},/obj/item/reagent_containers/condiment/milk{pixel_x = -5},/obj/item/reagent_containers/condiment/milk{pixel_x = 5},/obj/effect/turf_decal/siding/wood/corner{dir = 8},/turf/open/floor/wood,/area/shuttle/pirate/flying_dutchman)
"LJ" = (/obj/effect/mob_spawn/ghost_role/human/pirate/skeleton,/obj/effect/turf_decal/siding/wood{dir = 8},/turf/open/floor/wood/airless,/area/shuttle/pirate/flying_dutchman)
"Mj" = (/obj/structure/railing{dir = 4},/mob/living/basic/cow,/turf/open/floor/grass,/area/shuttle/pirate/flying_dutchman)
"MM" = (/obj/item/stack/cannonball/shellball/fourteen,/obj/effect/turf_decal/siding/wood{dir = 9},/turf/open/floor/wood,/area/shuttle/pirate/flying_dutchman)
"MN" = (/obj/effect/mapping_helpers/airlock/cutaiwire,/obj/machinery/door/airlock/vault{color = "#825427"; name = "Powder Storage"},/turf/open/floor/wood/airless,/area/shuttle/pirate/flying_dutchman)
"Nh" = (/obj/machinery/piratepad,/turf/open/floor/carpet/royalblack/airless,/area/shuttle/pirate/flying_dutchman)
"NB" = (/obj/structure/window/reinforced/shuttle/survival_pod,/turf/open/floor/wood/airless,/area/shuttle/pirate/flying_dutchman)
"NU" = (/obj/machinery/light/small/directional/east,/obj/effect/turf_decal/siding/wood{dir = 5},/turf/open/floor/wood,/area/shuttle/pirate/flying_dutchman)
"Ob" = (/obj/machinery/porta_turret/syndicate/energy{dir = 8; faction = list("pirate")},/turf/closed/wall/mineral/wood/nonmetal,/area/shuttle/pirate/flying_dutchman)
"Ox" = (/obj/machinery/light/small/directional/north,/obj/effect/turf_decal/siding/wood{dir = 1},/turf/open/floor/wood,/area/shuttle/pirate/flying_dutchman)
"OD" = (/obj/effect/mob_spawn/ghost_role/human/pirate/skeleton,/obj/effect/turf_decal/siding/wood,/turf/open/floor/wood,/area/shuttle/pirate/flying_dutchman)
"OR" = (/obj/effect/mob_spawn/ghost_role/human/pirate/skeleton,/turf/open/floor/wood/airless,/area/shuttle/pirate/flying_dutchman)
"Pc" = (/obj/structure/fermenting_barrel/gunpowder,/obj/item/reagent_containers/cup/bucket/wooden,/obj/item/reagent_containers/cup/bucket/wooden,/obj/machinery/light/small/directional/east,/turf/open/floor/wood/airless,/area/shuttle/pirate/flying_dutchman)
"Pj" = (/obj/machinery/light/small/directional/west,/obj/effect/turf_decal/siding/wood{dir = 8},/turf/open/floor/wood/airless,/area/shuttle/pirate/flying_dutchman)
"PB" = (/obj/effect/turf_decal/siding/wood{dir = 9},/obj/structure/table/wood,/obj/item/stack/cannonball/fourteen,/obj/item/flashlight/flare/torch,/obj/effect/turf_decal/siding/wood{dir = 5},/turf/open/floor/wood/airless,/area/shuttle/pirate/flying_dutchman)
"PH" = (/obj/effect/turf_decal/siding/wood,/obj/effect/turf_decal/siding/wood/corner{dir = 1},/obj/item/stack/cannonball/fourteen,/turf/open/floor/wood,/area/shuttle/pirate/flying_dutchman)
"PL" = (/obj/structure/rack,/obj/item/gun/energy/laser,/obj/item/gun/energy/laser{pixel_x = -3; pixel_y = 6},/obj/item/gun/energy/laser{pixel_y = 3},/obj/item/gun/energy/laser{pixel_y = 3},/obj/item/gun/energy/laser{pixel_y = 3},/obj/item/gun/energy/laser{pixel_y = 3},/obj/item/gun/energy/laser{pixel_y = 3},/obj/effect/turf_decal/siding/wood{dir = 5},/obj/machinery/light/small/directional/north,/turf/open/floor/wood,/area/shuttle/pirate/flying_dutchman)
"Qh" = (/obj/effect/turf_decal/siding/wood/end,/obj/structure/railing{dir = 1},/obj/structure/cannon{dir = 1},/turf/open/floor/plating/airless,/area/shuttle/pirate/flying_dutchman)
"Qk" = (/obj/effect/turf_decal/siding/wood/corner,/turf/open/floor/wood/airless,/area/shuttle/pirate/flying_dutchman)
"Rg" = (/obj/effect/turf_decal/siding/wood{dir = 5},/turf/open/floor/wood/airless,/area/shuttle/pirate/flying_dutchman)
"RF" = (/obj/structure/rack{icon = 'icons/obj/stationobjs.dmi'; icon_state = "minibar"; name = "skeletal minibar"},/obj/item/reagent_containers/condiment/milk{pixel_x = -5},/obj/item/reagent_containers/condiment/milk{pixel_x = 5},/turf/open/floor/wood,/area/shuttle/pirate/flying_dutchman)
"RP" = (/turf/open/floor/wood/airless,/area/shuttle/pirate/flying_dutchman)
"RX" = (/obj/structure/rack,/obj/item/gun/ballistic/shotgun/automatic/combat,/obj/item/gun/ballistic/shotgun/automatic/combat,/obj/item/storage/box/lethalshot,/obj/item/storage/box/lethalshot,/obj/effect/turf_decal/siding/wood{dir = 4},/turf/open/floor/wood,/area/shuttle/pirate/flying_dutchman)
"RZ" = (/obj/effect/turf_decal/siding/wood{dir = 1},/turf/open/floor/wood/airless,/area/shuttle/pirate/flying_dutchman)
"Sh" = (/obj/item/kirbyplants/random/dead,/turf/open/floor/stone,/area/shuttle/pirate/flying_dutchman)
"Sx" = (/obj/structure/stairs/wood{dir = 4},/turf/open/floor/wood/airless,/area/shuttle/pirate/flying_dutchman)
"SL" = (/obj/effect/turf_decal/siding/wood/corner,/obj/effect/mob_spawn/ghost_role/human/pirate/skeleton,/turf/open/floor/wood/airless,/area/shuttle/pirate/flying_dutchman)
"SM" = (/obj/structure/lattice/catwalk,/turf/closed/wall/mineral/wood/nonmetal,/area/shuttle/pirate/flying_dutchman)
"TT" = (/obj/effect/turf_decal/siding/wood{dir = 1},/turf/open/floor/wood,/area/shuttle/pirate/flying_dutchman)
"TV" = (/obj/effect/decal/cleanable/blood,/turf/open/floor/stone,/area/shuttle/pirate/flying_dutchman)
"UM" = (/obj/machinery/computer/shuttle/pirate{dir = 8},/turf/open/floor/carpet/royalblack/airless,/area/shuttle/pirate/flying_dutchman)
"UP" = (/obj/effect/mob_spawn/corpse/human,/turf/open/floor/stone,/area/shuttle/pirate/flying_dutchman)
"Vk" = (/obj/effect/decal/cleanable/blood,/obj/item/kirbyplants/random/dead,/turf/open/floor/stone,/area/shuttle/pirate/flying_dutchman)
"Vu" = (/obj/effect/turf_decal/siding/wood/end{dir = 8},/turf/open/floor/wood/airless,/area/shuttle/pirate/flying_dutchman)
"VI" = (/obj/structure/fermenting_barrel/gunpowder,/obj/item/reagent_containers/cup/bucket/wooden,/obj/item/reagent_containers/cup/bucket/wooden,/obj/effect/turf_decal/siding/wood{dir = 1},/turf/open/floor/wood/airless,/area/shuttle/pirate/flying_dutchman)
"Xk" = (/obj/machinery/computer/monitor{dir = 8},/turf/open/floor/carpet/royalblack/airless,/area/shuttle/pirate/flying_dutchman)
"XY" = (/obj/structure/railing{color = "#4C3117"; dir = 1; name = "wooden railing"},/turf/open/floor/wood/airless,/area/shuttle/pirate/flying_dutchman)
"Yw" = (/obj/machinery/computer/camera_advanced/shuttle_docker/syndicate/pirate{dir = 8; x_offset = -4; y_offset = -8},/turf/open/floor/carpet/royalblack/airless,/area/shuttle/pirate/flying_dutchman)
"ZK" = (/obj/effect/turf_decal/siding/wood/corner{dir = 4},/turf/open/floor/wood/airless,/area/shuttle/pirate/flying_dutchman)
"ZP" = (/obj/effect/turf_decal/siding/wood{dir = 9},/obj/structure/table/wood,/obj/item/stack/cannonball/fourteen,/obj/item/flashlight/flare/torch,/obj/machinery/recharger{pixel_y = 2},/obj/effect/turf_decal/siding/wood,/turf/open/floor/wood/airless,/area/shuttle/pirate/flying_dutchman)

(1,1,1) = {"
ldldldldldldldldldldldldldldldldpBldldldldldldldldldldldldldldldpBldldldldldldldldldldldldldldldldldldldld
ldldldldldldldldldldldldldldldpBrwpBldldldldldldldldldldldldldpBrwpBldldldldldldldldldldldldldldldldldldld
ldldldldldldldldldldldldldldldpBrwpBldldldldldldldldldldldldldpBrwpBldldldldldldldldldldldldldldldldldldld
ldldldldldldldldldldldldldldldpBrwpBpBldldldldldldldldldldldldpBrwpBpBldldldldldldldldldldldldldldldldldld
ldldldldldldldldldldldldldldldpBrwrwrwpBldldldldldldldldldldldpBrwrwrwpBldldldldldldldldldldldldldldldldld
ldldldldldldldldldldldldldldldpBrwrwpBldldldldldldldldldldldldpBrwrwpBldldldldldldldldldldldldldldldldldld
ldldldldldldldldldldldldldldldpBrwpBldldldldldldldldldldldldldpBrwpBldldldldldldldldldldldldldldldldldldld
ldldldldFoGgFoFoldldldldldldldpBrwpBldldldRPldldldldldldldldldpBrwpBldldldldldldldldldldldldldldldldldldld
ldldldFoFoJWPLFoFoldldldldldrwrwrwpBldldldiVldldldldldldldldgXrwrwpBldldldldldldldldldldldldldldldldldldld
ldldGgFoMMKAFNETFoFoGgAKNBFonMwwSMnMNBFonMiVFonMNBFonMNBFonMwwFonMNBFonMNBtunMNBFoFoFoldldldldldldldldldld
ldldFocgKAvoEbFNHUCsFoVuHDfyRZRPbrRZRZfyRZRPbrRZRZfyRZRZbrRZRPfyRZRZbrRZRZfyRZRZlqFoNBNBldldldldldldldldld
ldFoFoKleSoPoPeSeSRXFoFoPjRPRPRPRPRPRPRPRPRPRPRPRPRPRPRPRPRPRPRPRPRPRPRPRPRPRPRPZKRgNBNBFoldldldldldldldld
ldFopKPHFEODFEFEeSaEfIFoyTORRPRPRPRPRPRPRPRPRPRPRPRPRPRPRPRPRPORRPRPRPRPRPRPRPRPRPRPRZRgFoQhFoldldldldldld
ObFoFoFoFoFoFoFozMFoFoFoyTRPRPuzFoBWuzFoRPRPRPRPFoNBNBNBFoRPRPRPRPRPRPFoFoMNFoFoRPRPRPZKqxRgFoNBFoldldldld
FoCGMjrZxoTTOxTTeSTTNUFoPjJGLoFoejRPejFoQkJGpiRPFoERNhmANBRPRPQkJGpiRFFoejRPejFoRPQkJGpiRPZKVIPBFoFoNBFold
FoFDMjeueSeSeSeSmkeSeSeyfDxWoVFomrRPejFoaxxWLJRPSxRPRPUMNBRPRPfDxWoVRPFoejRPPcFotwfDxWyTRPRPRPZKRZqxRZRZvB
FoFDMjeumkeSmkeSeSeSeSeyfDxWoVFoejRPPcFofDxWyTRPSxtqRPYwNBRPRPfDxWyTRPFomrRPejFoRPfDxWyTRPRPRPQkJGyoJGJGha
FoCGMjeuDreSeSIUeSeSuOFoDXRZjKFoejRPejFoZKRZKgRPFoHTacXkNBRPRPZKRZKgRFFoejRPejFoRPZKRZKgRPQkyQzyFoFoNBFold
ObFoeYeYeYdACqeYeYeYeYFoyTORRPFoFoMNFoFoRPRPRPRPFoNBNBNBFoRPRPRPRPRPRPFoFoMNFoFoRPRPRPSLyoEHFoNBFoldldldld
ldFovfShGbtxekGbjrShvfFoyTRPRPRPRPRPRPRPRPRPORRPRPRPRPRPRPRPRPRPRPRPRPRPRPRPRPRPRPQkJGEHFoqIFoldldldldldld
ldFoFoTVUPaAektxgFjrFoFoPjRPRPRPRPRPRPRPRPRPRPRPRPRPORRPRPRPRPRPRPRPRPRPRPRPRPRPQkEHNBNBFoldldldldldldldld
ldldFoShHNtxlDHNVkcFFoVuKgZPJGJGEWJGJGZPJGRPEWJGJGZPJGRPEWJGJGZPJGJGEWRPRPZPJGJGkyFoNBNBldldldldldldldldld
ldldzQFoShekaAShFoFozQwQNBFoqINBFoqINBFoqIiVFoqINBFoqIwwFoqINBFoqINBFoqIiVFoqINBFoFoFoldldldldldldldldldld
ldldldFoFoykoIFoFoldldldldldrwrwrwpBldldldiVldldldldldAyldldrwrwrwpBldldIdXYldldldldldldldldldldldldldldld
ldldldldFozQFoFoldldldldldldldpBrwpBldldldRPldldldldldRPldldldpBrwpBldldldRPldldldldldldldldldldldldldldld
ldldldldldldldldldldldldldldldpBrwpBldldldldldldldldldldldldldpBrwpBldldldldldldldldldldldldldldldldldldld
ldldldldldldldldldldldldldldldpBrwpBldldldldldldldldldldldldldpBrwpBldldldldldldldldldldldldldldldldldldld
ldldldldldldldldldldldldldldldpBrwrwpBldldldldldldldldldldldldpBrwrwpBldldldldldldldldldldldldldldldldldld
ldldldldldldldldldldldldldldldpBrwrwrwpBldldldldldldldldldldldpBrwrwrwpBldldldldldldldldldldldldldldldldld
ldldldldldldldldldldldldldldldpBrwpBpBldldldldldldldldldldldldpBrwpBpBldldldldldldldldldldldldldldldldldld
ldldldldldldldldldldldldldldldpBrwpBldldldldldldldldldldldldldpBrwpBldldldldldldldldldldldldldldldldldldld
ldldldldldldldldldldldldldldldldpBldldldldldldldldldldldldldldldpBldldldldldldldldldldldldldldldldldldldld
"}
