"ad" = (/obj/effect/turf_decal/siding/wood{dir = 4},/obj/machinery/light/small/directional/east,/turf/open/floor/wood/airless,/area/shuttle/pirate/flying_dutchman)
"af" = (/mob/living/basic/cow,/obj/machinery/light/small/directional/west,/turf/open/floor/grass,/area/shuttle/pirate/flying_dutchman)
"aC" = (/obj/effect/decal/cleanable/blood,/turf/open/floor/stone,/area/shuttle/pirate/flying_dutchman)
"aN" = (/obj/item/stack/cannonball/shellball/fourteen,/obj/effect/turf_decal/siding/wood{dir = 9},/turf/open/floor/wood,/area/shuttle/pirate/flying_dutchman)
"bp" = (/turf/open/floor/wood/airless,/area/shuttle/pirate/flying_dutchman)
"by" = (/obj/structure/railing{color = "#4C3117"; dir = 1; name = "wooden railing"},/turf/open/floor/wood/airless,/area/shuttle/pirate/flying_dutchman)
"bT" = (/obj/structure/cannon,/turf/open/floor/wood,/area/shuttle/pirate/flying_dutchman)
"cg" = (/obj/effect/turf_decal/siding/wood/end,/turf/closed/wall/mineral/wood/nonmetal,/area/shuttle/pirate/flying_dutchman)
"cJ" = (/obj/structure/railing{color = "#4C3117"; dir = 8; name = "wooden railing"},/obj/structure/railing{color = "#4C3117"; dir = 4; name = "wooden railing"},/turf/open/floor/wood/airless,/area/shuttle/pirate/flying_dutchman)
"dW" = (/obj/effect/decal/cleanable/blood,/obj/item/kirbyplants/random/dead,/turf/open/floor/stone,/area/shuttle/pirate/flying_dutchman)
"dX" = (/obj/structure/rack{icon = 'icons/obj/stationobjs.dmi'; icon_state = "minibar"; name = "skeletal minibar"},/obj/item/reagent_containers/condiment/milk{pixel_x = -5},/obj/item/reagent_containers/condiment/milk{pixel_x = 5},/obj/effect/turf_decal/siding/wood{dir = 1},/turf/open/floor/wood,/area/shuttle/pirate/flying_dutchman)
"eC" = (/obj/structure/fermenting_barrel/gunpowder,/obj/item/reagent_containers/cup/bucket/wooden,/obj/item/reagent_containers/cup/bucket/wooden,/turf/open/floor/wood/airless,/area/shuttle/pirate/flying_dutchman)
"eZ" = (/obj/effect/mob_spawn/ghost_role/human/pirate/skeleton,/turf/open/floor/wood,/area/shuttle/pirate/flying_dutchman)
"fa" = (/obj/structure/closet/crate/coffin{pixel_y = 6; name = "The red captains coffin"},/obj/item/flashlight/flare/candle/infinite{pixel_x = -10; pixel_y = -9},/obj/item/flashlight/flare/candle/infinite{pixel_x = 14; pixel_y = -8},/obj/item/flashlight/flare/candle/infinite{pixel_x = -12; pixel_y = 15},/obj/item/flashlight/flare/candle/infinite{pixel_x = 10; pixel_y = 17},/mob/living/carbon/human/species/vampire{real_name = "The red captain"; faction = list("pirate")},/turf/open/floor/carpet/red,/area/shuttle/pirate/flying_dutchman)
"fP" = (/obj/structure/window/reinforced/shuttle/survival_pod,/turf/open/floor/wood/airless,/area/shuttle/pirate/flying_dutchman)
"fU" = (/obj/effect/turf_decal/siding/wood,/obj/effect/turf_decal/siding/wood/corner{dir = 1},/obj/item/stack/cannonball/fourteen,/turf/open/floor/wood,/area/shuttle/pirate/flying_dutchman)
"fV" = (/obj/machinery/light/small/directional/north,/obj/effect/turf_decal/siding/wood{dir = 1},/turf/open/floor/wood/airless,/area/shuttle/pirate/flying_dutchman)
"fY" = (/obj/effect/mapping_helpers/airlock/cutaiwire,/obj/machinery/door/airlock/cult/friendly{name = "Captains Quarters"},/turf/open/floor/carpet/red,/area/shuttle/pirate/flying_dutchman)
"gP" = (/obj/machinery/computer/monitor{dir = 8},/turf/open/floor/carpet/royalblack/airless,/area/shuttle/pirate/flying_dutchman)
"hw" = (/obj/item/reagent_containers/cup/bucket/wooden,/obj/effect/turf_decal/siding/wood{dir = 8},/turf/open/floor/wood,/area/shuttle/pirate/flying_dutchman)
"hW" = (/obj/effect/mob_spawn/corpse/human,/turf/open/floor/stone,/area/shuttle/pirate/flying_dutchman)
"ip" = (/obj/effect/turf_decal/siding/wood{dir = 1},/turf/open/floor/wood,/area/shuttle/pirate/flying_dutchman)
"iB" = (/obj/effect/turf_decal/siding/wood{dir = 1},/obj/effect/turf_decal/siding/wood/corner{dir = 8},/turf/open/floor/wood/airless,/area/shuttle/pirate/flying_dutchman)
"iI" = (/obj/effect/turf_decal/siding/wood{dir = 9},/obj/structure/table/wood,/obj/item/stack/cannonball/fourteen,/obj/item/flashlight/flare/torch,/obj/effect/turf_decal/siding/wood{dir = 6},/turf/open/floor/wood/airless,/area/shuttle/pirate/flying_dutchman)
"iS" = (/obj/structure/festivus{anchored = 1; color = "#825427"; desc = "A sturdy pole designed to hold the vessel's solar sails in place."; name = "mast"; pixel_x = -16; pixel_y = 2},/turf/closed/wall/mineral/wood/nonmetal,/area/shuttle/pirate/flying_dutchman)
"jJ" = (/obj/structure/rack{icon = 'icons/obj/stationobjs.dmi'; icon_state = "minibar"; name = "skeletal minibar"},/obj/item/reagent_containers/condiment/milk{pixel_x = -5},/obj/item/reagent_containers/condiment/milk{pixel_x = 5},/turf/open/floor/wood,/area/shuttle/pirate/flying_dutchman)
"jN" = (/obj/structure/rack,/obj/item/gun/energy/laser,/obj/item/gun/energy/laser{pixel_x = -3; pixel_y = 6},/obj/item/gun/energy/laser{pixel_y = 3},/obj/item/gun/energy/laser{pixel_y = 3},/obj/item/gun/energy/laser{pixel_y = 3},/obj/item/gun/energy/laser{pixel_y = 3},/obj/item/gun/energy/laser{pixel_y = 3},/obj/effect/turf_decal/siding/wood{dir = 5},/obj/machinery/light/small/directional/north,/turf/open/floor/wood,/area/shuttle/pirate/flying_dutchman)
"jP" = (/obj/effect/turf_decal/siding/wood/end{dir = 8},/turf/open/floor/wood/airless,/area/shuttle/pirate/flying_dutchman)
"jZ" = (/obj/machinery/light/small/directional/north,/obj/effect/turf_decal/siding/wood{dir = 5},/turf/open/floor/wood/airless,/area/shuttle/pirate/flying_dutchman)
"kk" = (/turf/open/floor/carpet/red,/area/shuttle/pirate/flying_dutchman)
"lq" = (/obj/item/reagent_containers/cup/bucket/wooden,/obj/effect/turf_decal/siding/wood{dir = 9},/turf/open/floor/wood,/area/shuttle/pirate/flying_dutchman)
"lx" = (/obj/structure/table,/obj/machinery/light/small/directional/west,/turf/open/floor/carpet/royalblack/airless,/area/shuttle/pirate/flying_dutchman)
"lJ" = (/obj/machinery/turretid{icon_state = "control_kill"; lethal = 1; locked = 0; pixel_y = -24; req_access = null},/turf/open/floor/wood/airless,/area/shuttle/pirate/flying_dutchman)
"lL" = (/obj/machinery/turretid{icon_state = "control_kill"; lethal = 1; locked = 0; pixel_y = -24; req_access = null},/turf/open/floor/wood,/area/shuttle/pirate/flying_dutchman)
"lQ" = (/obj/structure/rack{icon = 'icons/obj/stationobjs.dmi'; icon_state = "minibar"; name = "skeletal minibar"},/obj/item/reagent_containers/condiment/milk{pixel_x = -5},/obj/item/reagent_containers/condiment/milk{pixel_x = 5},/obj/effect/turf_decal/siding/wood/corner{dir = 8},/turf/open/floor/wood,/area/shuttle/pirate/flying_dutchman)
"lY" = (/obj/structure/railing{color = "#4C3117"; dir = 8; name = "wooden railing"},/obj/structure/railing{color = "#4C3117"; dir = 8; name = "wooden railing"},/obj/structure/railing{color = "#4C3117"; dir = 4; name = "wooden railing"},/turf/open/floor/wood/airless,/area/shuttle/pirate/flying_dutchman)
"mj" = (/obj/effect/turf_decal/siding/wood/corner{dir = 8},/turf/open/floor/wood/airless,/area/shuttle/pirate/flying_dutchman)
"mq" = (/obj/structure/fermenting_barrel/gunpowder,/obj/item/reagent_containers/cup/bucket/wooden,/obj/item/reagent_containers/cup/bucket/wooden,/obj/effect/turf_decal/siding/wood,/turf/open/floor/wood/airless,/area/shuttle/pirate/flying_dutchman)
"ny" = (/obj/effect/turf_decal/siding/wood{dir = 6},/turf/open/floor/wood/airless,/area/shuttle/pirate/flying_dutchman)
"pm" = (/obj/effect/turf_decal/siding/wood/corner{dir = 1},/turf/open/floor/wood/airless,/area/shuttle/pirate/flying_dutchman)
"pT" = (/obj/structure/railing{color = "#4C3117"; dir = 4; name = "wooden railing"},/obj/structure/railing{color = "#4C3117"; dir = 8; name = "wooden railing"},/turf/open/floor/wood/airless,/area/shuttle/pirate/flying_dutchman)
"qj" = (/obj/item/stack/sheet/mineral/wood/fifty,/turf/open/floor/wood,/area/shuttle/pirate/flying_dutchman)
"qA" = (/obj/machinery/porta_turret/syndicate/energy{dir = 1; faction = list("pirate")},/turf/closed/wall/mineral/wood/nonmetal,/area/shuttle/pirate/flying_dutchman)
"qV" = (/obj/structure/railing{dir = 1},/obj/effect/turf_decal/siding/wood/end,/obj/structure/cannon{dir = 1},/turf/open/floor/plating/airless,/area/shuttle/pirate/flying_dutchman)
"ri" = (/obj/effect/mapping_helpers/airlock/cutaiwire,/obj/machinery/door/airlock/vault{color = "#825427"; name = "Powder Storage"},/turf/open/floor/wood/airless,/area/shuttle/pirate/flying_dutchman)
"rC" = (/obj/effect/turf_decal/siding/wood{dir = 8},/obj/machinery/light/small/directional/west,/turf/open/floor/wood/airless,/area/shuttle/pirate/flying_dutchman)
"rM" = (/obj/structure/rack,/obj/item/claymore/cutlass{pixel_x = -4; pixel_y = 4},/obj/item/claymore/cutlass,/obj/item/claymore/cutlass,/obj/effect/turf_decal/siding/wood{dir = 5},/obj/item/claymore/cutlass,/obj/item/claymore/cutlass,/turf/open/floor/wood,/area/shuttle/pirate/flying_dutchman)
"rY" = (/obj/item/kirbyplants/random/dead,/turf/open/floor/stone,/area/shuttle/pirate/flying_dutchman)
"sn" = (/obj/effect/turf_decal/siding/wood,/obj/effect/turf_decal/siding/wood/corner{dir = 4},/turf/open/floor/wood,/area/shuttle/pirate/flying_dutchman)
"tw" = (/obj/effect/turf_decal/siding/wood{dir = 8},/obj/structure/closet/cabinet,/obj/item/restraints/legcuffs/bola,/obj/item/restraints/legcuffs/bola,/obj/item/restraints/legcuffs/bola,/obj/item/restraints/legcuffs/bola/tactical,/obj/item/restraints/legcuffs/bola/tactical,/obj/item/restraints/handcuffs/cable,/obj/item/restraints/handcuffs/cable,/obj/item/restraints/handcuffs/cable,/obj/item/restraints/handcuffs/cable,/turf/open/floor/wood,/area/shuttle/pirate/flying_dutchman)
"uc" = (/obj/structure/rack,/obj/item/claymore/cutlass,/obj/item/claymore/cutlass{pixel_x = -4; pixel_y = 4},/obj/item/claymore/cutlass,/obj/effect/turf_decal/siding/wood{dir = 5},/turf/open/floor/wood,/area/shuttle/pirate/flying_dutchman)
"uD" = (/obj/effect/turf_decal/siding/wood{dir = 9},/obj/structure/table/wood,/obj/item/stack/cannonball/fourteen,/obj/item/flashlight/flare/torch,/obj/effect/turf_decal/siding/wood{dir = 5},/turf/open/floor/wood/airless,/area/shuttle/pirate/flying_dutchman)
"uU" = (/obj/effect/decal/cleanable/blood,/obj/item/flashlight/flare/candle/infinite,/obj/machinery/light/small/directional/north,/turf/open/floor/stone,/area/shuttle/pirate/flying_dutchman)
"uY" = (/obj/effect/mob_spawn/ghost_role/human/pirate/skeleton,/turf/open/floor/wood/airless,/area/shuttle/pirate/flying_dutchman)
"ve" = (/obj/structure/railing{dir = 6},/obj/effect/turf_decal/siding/wood/end{dir = 4},/obj/structure/cannon{dir = 4},/turf/open/floor/plating/airless,/area/shuttle/pirate/flying_dutchman)
"vn" = (/obj/machinery/light/small/directional/east,/obj/effect/turf_decal/siding/wood{dir = 5},/turf/open/floor/wood,/area/shuttle/pirate/flying_dutchman)
"vF" = (/turf/open/floor/carpet/royalblack/airless,/area/shuttle/pirate/flying_dutchman)
"wm" = (/obj/effect/turf_decal/siding/wood/end,/obj/structure/railing,/obj/structure/cannon,/turf/open/floor/plating/airless,/area/shuttle/pirate/flying_dutchman)
"wn" = (/obj/structure/lattice/catwalk,/obj/structure/railing{color = "#4C3117"; dir = 8; name = "wooden railing"},/turf/open/space/basic,/area/shuttle/pirate/flying_dutchman)
"ww" = (/obj/effect/turf_decal/siding/wood/corner,/turf/open/floor/wood/airless,/area/shuttle/pirate/flying_dutchman)
"wZ" = (/obj/effect/mapping_helpers/airlock/cutaiwire,/obj/machinery/door/airlock/cult/friendly{name = "Captains Quarters"},/turf/open/floor/carpet/red/airless,/area/shuttle/pirate/flying_dutchman)
"xi" = (/obj/effect/turf_decal/siding/wood{dir = 9},/obj/structure/table/wood,/obj/item/stack/cannonball/fourteen,/obj/item/flashlight/flare/torch,/obj/machinery/light/small/directional/south,/obj/effect/turf_decal/siding/wood,/turf/open/floor/wood/airless,/area/shuttle/pirate/flying_dutchman)
"yF" = (/obj/effect/turf_decal/siding/wood{dir = 9},/obj/structure/table/wood,/obj/item/stack/cannonball/fourteen,/obj/item/flashlight/flare/torch,/obj/machinery/recharger{pixel_y = 2},/obj/effect/turf_decal/siding/wood{dir = 1},/turf/open/floor/wood/airless,/area/shuttle/pirate/flying_dutchman)
"zk" = (/obj/structure/rack,/obj/item/gun/energy/laser{pixel_y = 3},/obj/item/gun/energy/laser{pixel_x = -3; pixel_y = 6},/obj/item/gun/energy/laser,/obj/item/gun/energy/laser{pixel_y = 3},/obj/item/gun/energy/laser{pixel_y = 3},/obj/item/gun/energy/laser{pixel_y = 3},/obj/item/gun/energy/laser{pixel_y = 3},/obj/effect/turf_decal/siding/wood{dir = 9},/obj/machinery/light/small/directional/north,/turf/open/floor/wood,/area/shuttle/pirate/flying_dutchman)
"As" = (/obj/machinery/computer/camera_advanced/shuttle_docker/syndicate/pirate{dir = 8; x_offset = -4; y_offset = -8},/turf/open/floor/carpet/royalblack/airless,/area/shuttle/pirate/flying_dutchman)
"AC" = (/obj/structure/closet/cabinet{name = "The red captains cabinet"},/obj/item/clothing/shoes/pirate/armored,/obj/item/clothing/under/syndicate/bloodred{name = "blood-red suit"},/obj/item/clothing/suit/hooded/berserker{pressure_resistance = 10; min_cold_protection_temperature = 0; name = "Red captains armor"; desc = "Voices of the lost echo from the armor, looted and passed down through millenia of combat"; resistance_flags = 3},/obj/item/tank/jetpack/oxygen/security{name = "red captains jetpack"; desc = "A tank of compressed oxygen fitted for the red captain"},/obj/item/bedsheet/hos{name = "Red captains cloak"},/obj/item/card/id/advanced/black{trim = /datum/id_trim/pirate/captain; name = "The red captain"},/obj/item/radio/headset/syndicate/alt/leader{name = "red captains headset"},/turf/open/floor/stone,/area/shuttle/pirate/flying_dutchman)
"AV" = (/obj/structure/rack,/obj/item/gun/ballistic/shotgun/automatic/combat,/obj/item/gun/ballistic/shotgun/automatic/combat,/obj/item/storage/box/lethalshot,/obj/item/storage/box/lethalshot,/obj/effect/turf_decal/siding/wood/end{dir = 4},/turf/open/floor/wood,/area/shuttle/pirate/flying_dutchman)
"Bb" = (/obj/machinery/light/small/directional/west,/obj/effect/turf_decal/siding/wood{dir = 8},/obj/effect/turf_decal/siding/wood/corner{dir = 4},/turf/open/floor/wood/airless,/area/shuttle/pirate/flying_dutchman)
"Bd" = (/obj/effect/turf_decal/siding/wood{dir = 9},/obj/structure/table/wood,/obj/item/stack/cannonball/fourteen,/obj/item/flashlight/flare/torch,/obj/machinery/recharger{pixel_y = 2},/obj/effect/turf_decal/siding/wood,/turf/open/floor/wood/airless,/area/shuttle/pirate/flying_dutchman)
"Bf" = (/obj/item/stack/cannonball/the_big_one,/obj/effect/turf_decal/siding/wood/end{dir = 8},/turf/open/floor/wood,/area/shuttle/pirate/flying_dutchman)
"BH" = (/obj/structure/table/wood/fancy/black,/obj/item/gun/energy/beam_rifle{lefthand_file = icons/mob/inhands/weapons/melee_lefthand.dmi; righthand_file = icons/mob/inhands/weapons/melee_righthand.dmi; inhand_icon_state = powerfist; icon = 'icons/obj/device_syndie.dmi'; icon_state = "powerfist"; pixel_y = 5; pixel_x = 3; color = #669900; name = "Hand of the red captain"; desc = "A weapon of devestating potential looted from an experimental terran lab."; aiming_time_fire_threshold = 3; projectile_damage = 50},/obj/item/necromantic_stone,/turf/open/floor/carpet/red,/area/shuttle/pirate/flying_dutchman)
"Cb" = (/obj/effect/turf_decal/siding/wood/corner,/obj/effect/mob_spawn/ghost_role/human/pirate/skeleton,/turf/open/floor/wood/airless,/area/shuttle/pirate/flying_dutchman)
"CD" = (/obj/effect/turf_decal/siding/wood,/turf/open/floor/wood/airless,/area/shuttle/pirate/flying_dutchman)
"CS" = (/obj/structure/rack{icon = 'icons/obj/stationobjs.dmi'; icon_state = "minibar"; name = "skeletal minibar"},/obj/item/reagent_containers/condiment/milk{pixel_x = -5},/obj/item/reagent_containers/condiment/milk{pixel_x = 5},/obj/effect/turf_decal/siding/wood/corner{dir = 1},/turf/open/floor/wood,/area/shuttle/pirate/flying_dutchman)
"Eg" = (/obj/structure/railing,/obj/effect/turf_decal/siding/wood/end,/obj/structure/cannon,/turf/open/floor/plating/airless,/area/shuttle/pirate/flying_dutchman)
"Ei" = (/obj/structure/fermenting_barrel/gunpowder,/obj/item/reagent_containers/cup/bucket/wooden,/obj/item/reagent_containers/cup/bucket/wooden,/obj/effect/turf_decal/siding/wood{dir = 1},/turf/open/floor/wood/airless,/area/shuttle/pirate/flying_dutchman)
"EE" = (/obj/machinery/door/airlock/vault{color = "#825427"; name = "Ship Armoury"},/obj/effect/mapping_helpers/airlock/cutaiwire,/turf/open/floor/wood/airless,/area/shuttle/pirate/flying_dutchman)
"EV" = (/obj/item/stack/sheet/mineral/wood/fifty,/obj/effect/mob_spawn/ghost_role/human/pirate/skeleton,/turf/open/floor/wood,/area/shuttle/pirate/flying_dutchman)
"Fs" = (/obj/effect/turf_decal/siding/wood{dir = 1},/turf/open/floor/wood/airless,/area/shuttle/pirate/flying_dutchman)
"GE" = (/obj/effect/turf_decal/siding/wood/end{dir = 1},/obj/structure/railing{dir = 1},/obj/structure/cannon{dir = 1},/turf/open/floor/plating/airless,/area/shuttle/pirate/flying_dutchman)
"Hm" = (/obj/structure/lattice/catwalk,/turf/open/space/basic,/area/shuttle/pirate/flying_dutchman)
"Hn" = (/obj/effect/mob_spawn/corpse/human,/turf/open/floor/carpet/red,/area/shuttle/pirate/flying_dutchman)
"HT" = (/turf/closed/wall/mineral/wood/nonmetal,/area/shuttle/pirate/flying_dutchman)
"Ia" = (/turf/open/floor/iron/solarpanel/airless,/area/shuttle/pirate/flying_dutchman)
"Ig" = (/obj/structure/closet/crate/freezer/blood,/turf/open/floor/stone,/area/shuttle/pirate/flying_dutchman)
"Ij" = (/obj/structure/rack,/obj/item/gun/ballistic/shotgun/automatic/combat,/obj/item/gun/ballistic/shotgun/automatic/combat,/obj/item/storage/box/lethalshot,/obj/item/storage/box/lethalshot,/obj/effect/turf_decal/siding/wood{dir = 4},/turf/open/floor/wood,/area/shuttle/pirate/flying_dutchman)
"Is" = (/obj/structure/fermenting_barrel/gunpowder,/obj/item/reagent_containers/cup/bucket/wooden,/obj/item/reagent_containers/cup/bucket/wooden,/obj/machinery/light/small/directional/east,/turf/open/floor/wood/airless,/area/shuttle/pirate/flying_dutchman)
"Iz" = (/obj/effect/mob_spawn/ghost_role/human/pirate/skeleton,/obj/effect/turf_decal/siding/wood,/turf/open/floor/wood,/area/shuttle/pirate/flying_dutchman)
"IN" = (/obj/structure/table,/obj/machinery/light/small/directional/west,/obj/item/reagent_containers/cup/glass/bottle/whiskey{pixel_y = 8},/obj/item/reagent_containers/cup/glass{pixel_y = 8; pixel_x = -7},/obj/item/reagent_containers/cup/glass{pixel_y = 7; pixel_x = 8},/turf/open/floor/carpet/royalblack/airless,/area/shuttle/pirate/flying_dutchman)
"IP" = (/obj/structure/lattice/catwalk,/turf/closed/wall/mineral/wood/nonmetal,/area/shuttle/pirate/flying_dutchman)
"IS" = (/obj/effect/turf_decal/siding/wood{dir = 8},/turf/open/floor/wood/airless,/area/shuttle/pirate/flying_dutchman)
"Jp" = (/obj/machinery/light/small/directional/west,/obj/effect/turf_decal/siding/wood{dir = 8},/turf/open/floor/wood/airless,/area/shuttle/pirate/flying_dutchman)
"Ks" = (/turf/open/space/basic,/area/template_noop)
"KT" = (/turf/open/floor/stone,/area/shuttle/pirate/flying_dutchman)
"Lh" = (/obj/machinery/computer/shuttle/pirate{dir = 8},/turf/open/floor/carpet/royalblack/airless,/area/shuttle/pirate/flying_dutchman)
"LG" = (/obj/structure/rack{icon = 'icons/obj/stationobjs.dmi'; icon_state = "minibar"; name = "skeletal minibar"},/obj/item/reagent_containers/condiment/milk{pixel_x = 5},/obj/item/reagent_containers/condiment/milk{pixel_x = -5},/turf/open/floor/wood,/area/shuttle/pirate/flying_dutchman)
"LH" = (/obj/machinery/light/small/directional/south,/obj/effect/turf_decal/siding/wood{dir = 6},/turf/open/floor/wood/airless,/area/shuttle/pirate/flying_dutchman)
"LN" = (/obj/effect/turf_decal/siding/wood/corner{dir = 1},/turf/open/floor/wood,/area/shuttle/pirate/flying_dutchman)
"Mc" = (/obj/machinery/light/small/directional/east,/obj/effect/turf_decal/siding/wood{dir = 4},/turf/open/floor/wood,/area/shuttle/pirate/flying_dutchman)
"ME" = (/obj/effect/decal/cleanable/blood,/turf/open/floor/carpet/red,/area/shuttle/pirate/flying_dutchman)
"MO" = (/obj/machinery/computer/piratepad_control{dir = 8},/turf/open/floor/carpet/royalblack/airless,/area/shuttle/pirate/flying_dutchman)
"MV" = (/obj/effect/turf_decal/siding/wood/end,/obj/structure/railing{dir = 1},/obj/structure/cannon{dir = 1},/turf/open/floor/plating/airless,/area/shuttle/pirate/flying_dutchman)
"Nj" = (/obj/effect/turf_decal/siding/wood/corner,/turf/closed/wall/mineral/wood/nonmetal,/area/shuttle/pirate/flying_dutchman)
"NG" = (/obj/machinery/door/airlock/vault{color = "#825427"; name = "Ye Olde Strong Door"},/obj/effect/mapping_helpers/airlock/cutaiwire,/turf/open/floor/wood/airless,/area/shuttle/pirate/flying_dutchman)
"NN" = (/obj/effect/turf_decal/siding/wood/corner{dir = 4},/turf/open/floor/wood/airless,/area/shuttle/pirate/flying_dutchman)
"Oa" = (/obj/structure/railing{color = "#4C3117"; dir = 8; name = "wooden railing"},/obj/structure/railing/corner{color = "#4C3117"; dir = 4; name = "wooden railing"},/turf/open/floor/wood/airless,/area/shuttle/pirate/flying_dutchman)
"OC" = (/obj/machinery/light/small/directional/north,/obj/effect/turf_decal/siding/wood{dir = 1},/turf/open/floor/wood,/area/shuttle/pirate/flying_dutchman)
"OD" = (/turf/closed/wall/mineral/iron{name = "rough stone wall"; desc = "A wall with rough cobblestones forming a wall"},/area/shuttle/pirate/flying_dutchman)
"OP" = (/obj/effect/mapping_helpers/airlock/cutaiwire,/obj/machinery/door/airlock/vault{color = "#825427"; name = "Powder Storage"},/obj/effect/turf_decal/siding/wood/corner,/turf/open/floor/wood/airless,/area/shuttle/pirate/flying_dutchman)
"Pp" = (/obj/machinery/porta_turret/syndicate/energy{faction = list("pirate")},/turf/closed/wall/mineral/wood/nonmetal,/area/shuttle/pirate/flying_dutchman)
"Py" = (/obj/structure/rack,/obj/item/claymore/cutlass{pixel_x = -4; pixel_y = 4},/obj/item/claymore/cutlass,/obj/item/claymore/cutlass,/obj/item/claymore/cutlass,/obj/item/claymore/cutlass,/obj/machinery/light/small/directional/north,/turf/open/floor/wood,/area/shuttle/pirate/flying_dutchman)
"Qx" = (/obj/effect/turf_decal/siding/wood,/turf/open/floor/wood,/area/shuttle/pirate/flying_dutchman)
"Re" = (/obj/machinery/piratepad,/turf/open/floor/carpet/royalblack/airless,/area/shuttle/pirate/flying_dutchman)
"RG" = (/obj/structure/railing{dir = 5},/obj/effect/turf_decal/siding/wood/end{dir = 4},/obj/structure/cannon{dir = 4},/turf/open/floor/plating/airless,/area/shuttle/pirate/flying_dutchman)
"RJ" = (/obj/effect/mob_spawn/ghost_role/human/pirate/skeleton,/obj/effect/turf_decal/siding/wood{dir = 8},/turf/open/floor/wood/airless,/area/shuttle/pirate/flying_dutchman)
"Sv" = (/obj/structure/table/wood/fancy/black,/obj/item/vorpalscythe{name = "Headtaker"; force = 20; bonus_force_multiplier = 5; block_chance = 10; wound_bonus = 20; bare_wound_bonus = 25; desc = "The legendary scythe wielded by the red captain, decapitating foes with this weapon makes it significantly stronger"},/turf/open/floor/carpet/red,/area/shuttle/pirate/flying_dutchman)
"TA" = (/obj/structure/stairs/wood{dir = 4},/turf/open/floor/wood/airless,/area/shuttle/pirate/flying_dutchman)
"TT" = (/obj/item/flashlight/flare/candle/infinite,/turf/open/floor/carpet/red,/area/shuttle/pirate/flying_dutchman)
"Ud" = (/obj/machinery/light/small/directional/west,/turf/open/floor/wood/airless,/area/shuttle/pirate/flying_dutchman)
"Uz" = (/obj/effect/turf_decal/siding/wood{dir = 5},/turf/open/floor/wood/airless,/area/shuttle/pirate/flying_dutchman)
"UB" = (/obj/effect/turf_decal/siding/wood{dir = 9},/obj/structure/table/wood,/obj/item/stack/cannonball/fourteen,/obj/item/flashlight/flare/torch,/obj/machinery/light/small/directional/north,/obj/effect/turf_decal/siding/wood{dir = 1},/turf/open/floor/wood/airless,/area/shuttle/pirate/flying_dutchman)
"VY" = (/obj/structure/railing{dir = 4},/mob/living/basic/cow,/turf/open/floor/grass,/area/shuttle/pirate/flying_dutchman)
"We" = (/obj/item/stack/cannonball/emp,/obj/item/stack/cannonball/emp,/obj/item/stack/cannonball/emp{pixel_x = 8; pixel_y = 4},/obj/item/stack/cannonball/emp{pixel_y = -3; pixel_x = -1},/obj/item/stack/cannonball/emp{pixel_y = -5; pixel_x = 6},/obj/effect/turf_decal/siding/wood{dir = 9},/obj/machinery/light/small/directional/north,/obj/item/stack/cannonball/emp{pixel_y = -5; pixel_x = 6},/obj/item/stack/cannonball/emp{pixel_y = -5; pixel_x = 6},/obj/item/stack/cannonball/emp{pixel_y = -5; pixel_x = 6},/obj/item/stack/cannonball/emp{pixel_y = -5; pixel_x = 6},/obj/item/stack/cannonball/emp{pixel_y = -5; pixel_x = 6},/obj/item/stack/cannonball/emp{pixel_y = -5; pixel_x = 6},/obj/item/stack/cannonball/emp{pixel_y = -5; pixel_x = 6},/turf/open/floor/wood,/area/shuttle/pirate/flying_dutchman)
"Wg" = (/obj/structure/fermenting_barrel/gunpowder,/obj/item/reagent_containers/cup/bucket/wooden,/obj/item/reagent_containers/cup/bucket/wooden,/obj/machinery/light/small/directional/west,/turf/open/floor/wood/airless,/area/shuttle/pirate/flying_dutchman)
"WN" = (/turf/open/floor/wood,/area/shuttle/pirate/flying_dutchman)
"XI" = (/obj/item/flashlight/flare/candle/infinite,/turf/open/floor/stone,/area/shuttle/pirate/flying_dutchman)
"YA" = (/mob/living/basic/cow,/turf/open/floor/grass,/area/shuttle/pirate/flying_dutchman)
"YX" = (/obj/effect/turf_decal/siding/wood/corner{dir = 4},/turf/open/floor/wood,/area/shuttle/pirate/flying_dutchman)
"ZL" = (/obj/machinery/light/small/directional/south,/obj/effect/turf_decal/siding/wood,/turf/open/floor/wood/airless,/area/shuttle/pirate/flying_dutchman)
"ZV" = (/obj/effect/turf_decal/siding/wood{dir = 4},/turf/open/floor/wood/airless,/area/shuttle/pirate/flying_dutchman)
"ZW" = (/obj/machinery/porta_turret/syndicate/energy{dir = 8; faction = list("pirate")},/turf/closed/wall/mineral/wood/nonmetal,/area/shuttle/pirate/flying_dutchman)

(1,1,1) = {"
KsKsKsKsKsKsKsKsKsKsKsKsKsKsKsKsIaKsKsKsKsKsKsKsKsKsKsKsKsKsKsKsIaKsKsKsKsKsKsKsKsKsKsKsKsKsKsKsKsKsKsKsKs
KsKsKsKsKsKsKsKsKsKsKsKsKsKsKsIaHmIaKsKsKsKsKsKsKsKsKsKsKsKsKsIaHmIaKsKsKsKsKsKsKsKsKsKsKsKsKsKsKsKsKsKsKs
KsKsKsKsKsKsKsKsKsKsKsKsKsKsKsIaHmIaKsKsKsKsKsKsKsKsKsKsKsKsKsIaHmIaKsKsKsKsKsKsKsKsKsKsKsKsKsKsKsKsKsKsKs
KsKsKsKsKsKsKsKsKsKsKsKsKsKsKsIaHmIaIaKsKsKsKsKsKsKsKsKsKsKsKsIaHmIaIaKsKsKsKsKsKsKsKsKsKsKsKsKsKsKsKsKsKs
KsKsKsKsKsKsKsKsKsKsKsKsKsKsKsIaHmHmHmIaKsKsKsKsKsKsKsKsKsKsKsIaHmHmHmIaKsKsKsKsKsKsKsKsKsKsKsKsKsKsKsKsKs
KsKsKsKsKsKsKsKsKsKsKsKsKsKsKsIaHmHmIaKsKsKsKsKsKsKsKsKsKsKsKsIaHmHmIaKsKsKsKsKsKsKsKsKsKsKsKsKsKsKsKsKsKs
KsKsKsKsKsKsKsKsKsKsKsKsKsKsKsIaHmIaKsKsKsKsKsKsKsKsKsKsKsKsKsIaHmIaKsKsKsKsKsKsKsKsKsKsKsKsKsKsKsKsKsKsKs
KsKsKsKsHTqAHTHTKsKsKsKsKsKsKsIaHmIaKsKsKsbpKsKsKsKsKsKsKsKsKsIaHmIaKsKsKsKsKsKsKsKsKsKsKsKsKsKsKsKsKsKsKs
KsKsKsHTHTzkjNHTHTKsKsKsKsKsHmHmHmIaKsKsKspTKsKsKsKsKsKsKsKswnHmHmIaKsKsKsKsKsKsKsKsKsKsKsKsKsKsKsKsKsKsKs
KsKsqAHTaNLNYXucHTHTqAGEfPHTqVcJIPqVfPHTqVpTHTqVfPHTqVfPHTqVcJHTqVfPHTqVfPcgqVfPHTHTHTKsKsKsKsKsKsKsKsKsKs
KsKsHTWeLNqjEVYXPyrMHTjPiByFFsbpUBFsFsyFFsbpUBFsFsyFFsFsUBFsbpyFFsFsUBFsFsyFFsFsjZHTfPfPKsKsKsKsKsKsKsKsKs
KsHTHTtwWNbTbTWNWNIjHTHTJpbpbpbpbpbpbpbpbpbpbpbpbpbpbpbpbpbpbpbpbpbpbpbpbpbpbpbpNNUzfPfPHTKsKsKsKsKsKsKsKs
KsHTBffUQxIzQxQxWNsnAVHTISuYbpbpbpbpbpbpbpbpbpbpbpbpbpbpbpbpbpuYbpbpbpbpbpbpbpbpbpbpFsUzHTMVHTKsKsKsKsKsKs
ZWHTHTHTHTHTHTHTEEHTHTHTISbpbpNjHTOPNjHTbpbpbpbpHTfPfPfPHTbpbpbpbpbpbpHTHTriHTHTbpbpbpNNfVUzHTfPHTKsKsKsKs
HTafVYlqdXipOCipWNipvnHTJpCDlQHTeCbpeCHTwwCDmjbpHTINReMOfPbpbpwwCDmjjJHTeCbpeCHTbpwwCDmjbpNNEiuDHTHTfPHTKs
HTYAVYhwWNWNWNWNeZWNWNNGZViSrCHTWgbpeCHTadiSRJbpTAbpbpLhfPbpbpZViSrCbpHTeCbpIsHTUdZViSISbpbpbpNNFsfVFsFsRG
HTYAVYhweZWNeZWNWNWNWNNGZViSrCHTeCbpIsHTZViSISbpTAlJbpAsfPbpbpZViSISbpHTWgbpeCHTbpZViSISbpbpbpwwCDZLCDCDve
HTafVYhwLGWNWNlLWNWNMcHTBbFsCSHTeCbpeCHTNNFspmbpHTlxvFgPfPbpbpNNFspmjJHTeCbpeCHTbpNNFspmbpwwmqiIHTHTfPHTKs
ZWHTODODODfYwZODODODODHTISuYbpHTHTriHTHTbpbpbpbpHTfPfPfPHTbpbpbpbpbpbpHTHTriHTHTbpbpbpCbZLnyHTfPHTKsKsKsKs
KsHTIgrYuUMEkkuUKTrYIgHTISbpbpbpbpbpbpbpbpbpuYbpbpbpbpbpbpbpbpbpbpbpbpbpbpbpbpbpbpwwCDnyHTEgHTKsKsKsKsKsKs
KsHTHTaChWTTkkMEfaKTHTHTJpbpbpbpbpbpbpbpbpbpbpbpbpbpuYbpbpbpbpbpbpbpbpbpbpbpbpbpwwnyfPfPHTKsKsKsKsKsKsKsKs
KsKsHTrYXIMEHnXIdWACHTjPpmBdCDCDxiCDCDBdCDbpxiCDCDBdCDbpxiCDCDBdCDCDxibpbpBdCDCDLHHTfPfPKsKsKsKsKsKsKsKsKs
KsKsPpHTrYkkTTrYHTHTPpwmfPHTEgfPHTEgfPHTEgpTHTEgfPHTEgcJHTEgfPHTEgfPHTEgpTHTEgfPHTHTHTKsKsKsKsKsKsKsKsKsKs
KsKsKsHTHTBHSvHTHTKsKsKsKsKsHmHmHmIaKsKsKspTKsKsKsKsKslYKsKsHmHmHmIaKsKsOabyKsKsKsKsKsKsKsKsKsKsKsKsKsKsKs
KsKsKsKsHTPpHTHTKsKsKsKsKsKsKsIaHmIaKsKsKsbpKsKsKsKsKsbpKsKsKsIaHmIaKsKsKsbpKsKsKsKsKsKsKsKsKsKsKsKsKsKsKs
KsKsKsKsKsKsKsKsKsKsKsKsKsKsKsIaHmIaKsKsKsKsKsKsKsKsKsKsKsKsKsIaHmIaKsKsKsKsKsKsKsKsKsKsKsKsKsKsKsKsKsKsKs
KsKsKsKsKsKsKsKsKsKsKsKsKsKsKsIaHmIaKsKsKsKsKsKsKsKsKsKsKsKsKsIaHmIaKsKsKsKsKsKsKsKsKsKsKsKsKsKsKsKsKsKsKs
KsKsKsKsKsKsKsKsKsKsKsKsKsKsKsIaHmHmIaKsKsKsKsKsKsKsKsKsKsKsKsIaHmHmIaKsKsKsKsKsKsKsKsKsKsKsKsKsKsKsKsKsKs
KsKsKsKsKsKsKsKsKsKsKsKsKsKsKsIaHmHmHmIaKsKsKsKsKsKsKsKsKsKsKsIaHmHmHmIaKsKsKsKsKsKsKsKsKsKsKsKsKsKsKsKsKs
KsKsKsKsKsKsKsKsKsKsKsKsKsKsKsIaHmIaIaKsKsKsKsKsKsKsKsKsKsKsKsIaHmIaIaKsKsKsKsKsKsKsKsKsKsKsKsKsKsKsKsKsKs
KsKsKsKsKsKsKsKsKsKsKsKsKsKsKsIaHmIaKsKsKsKsKsKsKsKsKsKsKsKsKsIaHmIaKsKsKsKsKsKsKsKsKsKsKsKsKsKsKsKsKsKsKs
KsKsKsKsKsKsKsKsKsKsKsKsKsKsKsKsIaKsKsKsKsKsKsKsKsKsKsKsKsKsKsKsIaKsKsKsKsKsKsKsKsKsKsKsKsKsKsKsKsKsKsKsKs
"}
