"aj" = (/obj/effect/turf_decal/siding/wood,/obj/effect/turf_decal/siding/wood/corner{dir = 4},/turf/open/floor/wood,/area/shuttle/pirate)
"au" = (/obj/structure/closet/crate/freezer/blood,/turf/open/floor/stone,/area/shuttle/pirate)
"bP" = (/obj/structure/rack{icon = 'icons/obj/stationobjs.dmi'; icon_state = "minibar"; name = "skeletal minibar"},/obj/item/reagent_containers/condiment/milk{pixel_x = -5},/obj/item/reagent_containers/condiment/milk{pixel_x = 5},/turf/open/floor/wood,/area/shuttle/pirate)
"bX" = (/obj/effect/turf_decal/siding/wood/corner{dir = 4},/turf/open/floor/wood/airless,/area/shuttle/pirate)
"cP" = (/obj/structure/rack,/obj/item/claymore/cutlass{pixel_x = -4; pixel_y = 4},/obj/item/claymore/cutlass,/obj/item/claymore/cutlass,/obj/item/claymore/cutlass,/obj/item/claymore/cutlass,/obj/machinery/light/small/directional/north,/turf/open/floor/wood,/area/shuttle/pirate)
"dh" = (/obj/machinery/door/airlock/vault{color = "#825427"; name = "Ship Armoury"},/obj/effect/mapping_helpers/airlock/cutaiwire,/obj/structure/fans/tiny/invisible,/turf/open/floor/wood/airless,/area/shuttle/pirate)
"dt" = (/obj/item/reagent_containers/cup/bucket/wooden,/obj/effect/turf_decal/siding/wood{dir = 8},/obj/structure/fans/tiny/invisible,/turf/open/floor/wood,/area/shuttle/pirate)
"dQ" = (/turf/open/floor/wood/airless,/area/shuttle/pirate)
"dR" = (/obj/item/stack/cannonball/emp,/obj/item/stack/cannonball/emp,/obj/item/stack/cannonball/emp{pixel_x = 8; pixel_y = 4},/obj/item/stack/cannonball/emp{pixel_y = -3; pixel_x = -1},/obj/item/stack/cannonball/emp{pixel_y = -5; pixel_x = 6},/obj/effect/turf_decal/siding/wood{dir = 9},/obj/machinery/light/small/directional/north,/obj/item/stack/cannonball/emp{pixel_y = -5; pixel_x = 6},/obj/item/stack/cannonball/emp{pixel_y = -5; pixel_x = 6},/obj/item/stack/cannonball/emp{pixel_y = -5; pixel_x = 6},/obj/item/stack/cannonball/emp{pixel_y = -5; pixel_x = 6},/obj/item/stack/cannonball/emp{pixel_y = -5; pixel_x = 6},/obj/item/stack/cannonball/emp{pixel_y = -5; pixel_x = 6},/obj/item/stack/cannonball/emp{pixel_y = -5; pixel_x = 6},/turf/open/floor/wood,/area/shuttle/pirate)
"ed" = (/turf/open/floor/wood/airless{icon = 'icons/obj/stairs.dmi'; base_icon_state = null; icon_state = "stairs_wood"; dir = 4},/area/shuttle/pirate)
"ej" = (/obj/machinery/light/small/directional/west,/obj/effect/turf_decal/siding/wood{dir = 8},/obj/effect/turf_decal/siding/wood/corner{dir = 4},/turf/open/floor/carpet/red/airless,/area/shuttle/pirate)
"ek" = (/obj/effect/turf_decal/siding/wood{dir = 8},/turf/open/floor/carpet/red/airless,/area/shuttle/pirate)
"es" = (/obj/structure/table/wood,/obj/item/stack/cannonball/fourteen,/obj/item/flashlight/flare/torch,/obj/machinery/light/small/directional/north,/obj/effect/turf_decal/siding/wood{dir = 1},/turf/open/floor/wood/airless,/area/shuttle/pirate)
"eB" = (/obj/structure/railing{color = "#4C3117"; dir = 1; name = "wooden railing"},/turf/open/floor/wood/airless,/area/shuttle/pirate)
"eE" = (/obj/effect/turf_decal/siding/wood,/turf/open/floor/wood,/area/shuttle/pirate)
"fi" = (/obj/machinery/light/small/directional/west,/obj/effect/turf_decal/siding/wood{dir = 8},/turf/open/floor/carpet/red/airless,/area/shuttle/pirate)
"fE" = (/turf/open/floor/carpet/red,/area/shuttle/pirate)
"fF" = (/obj/effect/turf_decal/siding/wood{dir = 1},/turf/open/floor/carpet/red/airless,/area/shuttle/pirate)
"fJ" = (/obj/effect/turf_decal/siding/wood{dir = 1},/turf/open/floor/wood,/area/shuttle/pirate)
"gT" = (/obj/machinery/light/small/directional/north,/obj/effect/turf_decal/siding/wood{dir = 1},/turf/open/floor/wood,/area/shuttle/pirate)
"hr" = (/obj/structure/cannon,/turf/open/floor/wood,/area/shuttle/pirate)
"hx" = (/obj/effect/mapping_helpers/airlock/cutaiwire,/obj/machinery/door/airlock/vault{color = "#825427"; name = "Powder Storage"},/obj/effect/turf_decal/siding/wood/corner,/turf/open/floor/wood/airless,/area/shuttle/pirate)
"hI" = (/obj/effect/turf_decal/siding/wood{dir = 5},/turf/open/floor/wood/airless,/area/shuttle/pirate)
"ib" = (/obj/structure/railing{dir = 1},/obj/effect/turf_decal/siding/wood/end,/obj/structure/cannon{dir = 1},/turf/open/floor/plating/airless,/area/shuttle/pirate)
"it" = (/obj/structure/fermenting_barrel/gunpowder,/obj/item/reagent_containers/cup/bucket/wooden,/obj/item/reagent_containers/cup/bucket/wooden,/obj/machinery/light/small/directional/west,/turf/open/floor/wood/airless,/area/shuttle/pirate)
"iD" = (/obj/effect/turf_decal/siding/wood/corner,/obj/effect/mob_spawn/ghost_role/human/pirate/skeleton,/turf/open/floor/wood/airless,/area/shuttle/pirate)
"jc" = (/obj/structure/table/wood,/obj/item/stack/cannonball/fourteen,/obj/item/flashlight/flare/torch,/obj/machinery/light/small/directional/south,/obj/effect/turf_decal/siding/wood,/turf/open/floor/wood/airless,/area/shuttle/pirate)
"je" = (/obj/machinery/turretid{icon_state = "control_kill"; lethal = 1; locked = 0; pixel_y = -24; req_access = null},/turf/open/floor/wood,/area/shuttle/pirate)
"jA" = (/obj/structure/railing{dir = 4},/mob/living/basic/cow,/turf/open/floor/grass,/area/shuttle/pirate)
"kd" = (/obj/structure/table/wood,/obj/machinery/recharger{pixel_y = 2},/obj/effect/turf_decal/siding/wood,/turf/open/floor/wood/airless,/area/shuttle/pirate)
"kB" = (/obj/item/flashlight/flare/candle/infinite,/turf/open/floor/stone,/area/shuttle/pirate)
"kR" = (/obj/effect/turf_decal/siding/wood/corner,/turf/closed/wall/mineral/wood/nonmetal,/area/shuttle/pirate)
"kU" = (/turf/open/floor/iron/solarpanel/airless,/area/shuttle/pirate)
"lp" = (/obj/effect/turf_decal/siding/wood{dir = 4},/obj/machinery/light/small/directional/east,/obj/machinery/light/small/directional/west,/obj/machinery/light/small/directional/west,/turf/open/floor/carpet/red/airless,/area/shuttle/pirate)
"lR" = (/obj/effect/mob_spawn/ghost_role/human/pirate/skeleton,/turf/open/floor/wood/airless,/area/shuttle/pirate)
"mb" = (/obj/structure/rack{icon = 'icons/obj/stationobjs.dmi'; icon_state = "minibar"; name = "skeletal minibar"},/obj/item/reagent_containers/condiment/milk{pixel_x = 5},/obj/item/reagent_containers/condiment/milk{pixel_x = -5},/turf/open/floor/wood,/area/shuttle/pirate)
"mC" = (/obj/structure/lattice/catwalk,/turf/open/space/basic,/area/shuttle/pirate)
"mY" = (/obj/effect/mapping_helpers/airlock/cutaiwire,/obj/machinery/door/airlock/vault{color = "#825427"; name = "Powder Storage"},/turf/open/floor/wood/airless,/area/shuttle/pirate)
"nt" = (/obj/effect/turf_decal/siding/wood{dir = 4},/turf/open/floor/carpet/red/airless,/area/shuttle/pirate)
"op" = (/obj/item/flashlight/flare/candle/infinite,/turf/open/floor/carpet/red,/area/shuttle/pirate)
"oq" = (/obj/effect/turf_decal/siding/wood/corner,/turf/open/floor/carpet/red/airless,/area/shuttle/pirate)
"ov" = (/obj/effect/mob_spawn/ghost_role/human/pirate/skeleton,/obj/effect/turf_decal/siding/wood,/turf/open/floor/wood,/area/shuttle/pirate)
"pE" = (/obj/effect/turf_decal/siding/wood{dir = 4},/obj/machinery/light/small/directional/east,/turf/open/floor/carpet/red/airless,/area/shuttle/pirate)
"qf" = (/obj/effect/turf_decal/siding/wood{dir = 8},/turf/open/floor/wood/airless,/area/shuttle/pirate)
"qu" = (/obj/docking_port/stationary{dir = 4; dwidth = 13; height = 60; name = "Deep Space"; shuttle_id = "pirate_home"; width = 26},/turf/open/floor/iron/solarpanel/airless,/area/shuttle/pirate)
"qP" = (/turf/open/floor/wood,/area/shuttle/pirate)
"qY" = (/obj/machinery/light/small/directional/east,/obj/effect/turf_decal/siding/wood{dir = 4},/turf/open/floor/wood,/area/shuttle/pirate)
"rf" = (/obj/effect/turf_decal/siding/wood/end,/obj/structure/railing,/obj/structure/cannon,/turf/open/floor/plating/airless,/area/shuttle/pirate)
"rm" = (/obj/structure/rack,/obj/item/gun/ballistic/shotgun/automatic/combat,/obj/item/gun/ballistic/shotgun/automatic/combat,/obj/item/storage/box/lethalshot,/obj/item/storage/box/lethalshot,/obj/effect/turf_decal/siding/wood/end{dir = 4},/turf/open/floor/wood,/area/shuttle/pirate)
"rn" = (/obj/structure/railing{color = "#4C3117"; dir = 8; name = "wooden railing"},/obj/structure/railing{color = "#4C3117"; dir = 4; name = "wooden railing"},/turf/open/floor/wood/airless,/area/shuttle/pirate)
"sc" = (/obj/effect/turf_decal/siding/wood{dir = 8},/obj/structure/closet/cabinet,/obj/item/restraints/legcuffs/bola,/obj/item/restraints/legcuffs/bola,/obj/item/restraints/legcuffs/bola,/obj/item/restraints/legcuffs/bola/tactical,/obj/item/restraints/legcuffs/bola/tactical,/obj/item/restraints/handcuffs/cable,/obj/item/restraints/handcuffs/cable,/obj/item/restraints/handcuffs/cable,/obj/item/restraints/handcuffs/cable,/turf/open/floor/wood,/area/shuttle/pirate)
"so" = (/obj/machinery/porta_turret/syndicate/energy{dir = 8; faction = list("pirate")},/turf/closed/wall/mineral/wood/nonmetal,/area/shuttle/pirate)
"su" = (/obj/item/kirbyplants/random/dead,/turf/open/floor/stone,/area/shuttle/pirate)
"sM" = (/obj/item/stack/cannonball/the_big_one,/obj/effect/turf_decal/siding/wood/end{dir = 8},/turf/open/floor/wood,/area/shuttle/pirate)
"tt" = (/obj/effect/mapping_helpers/airlock/cutaiwire,/obj/machinery/door/airlock/cult/friendly{name = "Captains Quarters"},/obj/structure/fans/tiny/invisible,/turf/open/floor/carpet/red/airless,/area/shuttle/pirate)
"tz" = (/obj/item/reagent_containers/cup/bucket/wooden,/obj/effect/turf_decal/siding/wood{dir = 9},/obj/structure/fans/tiny/invisible,/turf/open/floor/wood,/area/shuttle/pirate)
"un" = (/obj/structure/table/wood,/obj/item/stack/cannonball/fourteen,/obj/item/flashlight/flare/torch,/obj/effect/turf_decal/siding/wood{dir = 5},/turf/open/floor/wood/airless,/area/shuttle/pirate)
"uB" = (/obj/effect/mapping_helpers/airlock/cutaiwire,/obj/machinery/door/airlock/cult/friendly{name = "Captains Quarters"},/obj/structure/fans/tiny/invisible,/turf/open/floor/carpet/red,/area/shuttle/pirate)
"vs" = (/obj/effect/turf_decal/siding/wood/end{dir = 1},/obj/structure/railing{dir = 1},/obj/structure/cannon{dir = 1},/turf/open/floor/plating/airless,/area/shuttle/pirate)
"vx" = (/obj/effect/turf_decal/siding/wood/end,/obj/structure/railing{dir = 1},/obj/structure/cannon{dir = 1},/turf/open/floor/plating/airless,/area/shuttle/pirate)
"vZ" = (/obj/effect/turf_decal/siding/wood,/obj/effect/turf_decal/siding/wood/corner{dir = 1},/obj/item/stack/cannonball/fourteen,/turf/open/floor/wood,/area/shuttle/pirate)
"wd" = (/obj/effect/mob_spawn/ghost_role/human/pirate/skeleton,/obj/effect/turf_decal/siding/wood{dir = 8},/turf/open/floor/carpet/red/airless,/area/shuttle/pirate)
"wj" = (/obj/structure/window/reinforced/shuttle/survival_pod,/turf/open/floor/wood/airless,/area/shuttle/pirate)
"wr" = (/obj/effect/decal/cleanable/blood,/turf/open/floor/carpet/red,/area/shuttle/pirate)
"wt" = (/turf/closed/wall/mineral/iron{name = "rough stone wall"; desc = "A wall with rough cobblestones forming a wall"},/area/shuttle/pirate)
"wB" = (/mob/living/basic/cow,/obj/machinery/light/small/directional/west,/turf/open/floor/grass,/area/shuttle/pirate)
"wM" = (/obj/structure/chair/comfy/shuttle{dir = 1},/turf/open/floor/carpet/royalblack/airless,/area/shuttle/pirate)
"wT" = (/obj/structure/rack,/obj/item/claymore/cutlass{pixel_x = -4; pixel_y = 4},/obj/item/claymore/cutlass,/obj/item/claymore/cutlass,/obj/effect/turf_decal/siding/wood{dir = 5},/obj/item/claymore/cutlass,/obj/item/claymore/cutlass,/turf/open/floor/wood,/area/shuttle/pirate)
"wV" = (/obj/structure/table/wood,/obj/machinery/recharger{pixel_y = 2},/obj/effect/turf_decal/siding/wood{dir = 1},/obj/item/binoculars,/turf/open/floor/wood/airless,/area/shuttle/pirate)
"xk" = (/obj/structure/railing,/obj/effect/turf_decal/siding/wood/end,/obj/structure/cannon,/turf/open/floor/plating/airless,/area/shuttle/pirate)
"xm" = (/turf/closed/wall/mineral/wood/nonmetal,/area/shuttle/pirate)
"xG" = (/obj/effect/decal/cleanable/blood,/obj/item/flashlight/flare/candle/infinite,/obj/machinery/light/small/directional/north,/turf/open/floor/stone,/area/shuttle/pirate)
"xH" = (/obj/effect/turf_decal/siding/wood/corner{dir = 1},/turf/open/floor/wood/airless,/area/shuttle/pirate)
"xT" = (/obj/effect/turf_decal/siding/wood/corner{dir = 1},/turf/open/floor/wood,/area/shuttle/pirate)
"yl" = (/obj/structure/fermenting_barrel/gunpowder,/obj/item/reagent_containers/cup/bucket/wooden,/obj/item/reagent_containers/cup/bucket/wooden,/turf/open/floor/wood/airless,/area/shuttle/pirate)
"zl" = (/obj/machinery/computer/monitor{dir = 8},/turf/open/floor/carpet/royalblack/airless,/area/shuttle/pirate)
"Av" = (/obj/effect/turf_decal/siding/wood{dir = 1},/turf/open/floor/wood/airless,/area/shuttle/pirate)
"AH" = (/obj/machinery/light/small/directional/south,/obj/effect/turf_decal/siding/wood,/turf/open/floor/wood/airless,/area/shuttle/pirate)
"AL" = (/obj/machinery/light/small/directional/east,/obj/effect/turf_decal/siding/wood{dir = 5},/turf/open/floor/wood,/area/shuttle/pirate)
"AW" = (/obj/structure/table,/obj/machinery/light/small/directional/west,/obj/item/binoculars,/turf/open/floor/carpet/royalblack/airless,/area/shuttle/pirate)
"Ba" = (/obj/effect/turf_decal/siding/wood,/turf/open/floor/carpet/red/airless,/area/shuttle/pirate)
"CJ" = (/obj/structure/rack,/obj/item/claymore/cutlass,/obj/item/claymore/cutlass{pixel_x = -4; pixel_y = 4},/obj/item/claymore/cutlass,/obj/effect/turf_decal/siding/wood{dir = 5},/turf/open/floor/wood,/area/shuttle/pirate)
"CS" = (/obj/effect/mob_spawn/ghost_role/human/pirate/skeleton,/turf/open/floor/wood,/area/shuttle/pirate)
"EE" = (/obj/structure/table/wood,/obj/item/stack/cannonball/fourteen,/obj/item/flashlight/flare/torch,/obj/effect/turf_decal/siding/wood{dir = 6},/turf/open/floor/wood/airless,/area/shuttle/pirate)
"Fa" = (/obj/structure/lattice/catwalk,/obj/structure/railing{color = "#4C3117"; dir = 8; name = "wooden railing"},/turf/open/space/basic,/area/shuttle/pirate)
"FG" = (/obj/structure/table/wood,/obj/machinery/recharger{pixel_y = 2},/obj/effect/turf_decal/siding/wood,/obj/item/binoculars,/turf/open/floor/wood/airless,/area/shuttle/pirate)
"FQ" = (/obj/structure/table/wood/fancy/black,/obj/item/gun/energy/beam_rifle{lefthand_file = icons/mob/inhands/weapons/melee_lefthand.dmi; righthand_file = icons/mob/inhands/weapons/melee_righthand.dmi; inhand_icon_state = powerfist; icon = 'icons/obj/device_syndie.dmi'; icon_state = "powerfist"; pixel_y = 5; pixel_x = 3; color = #669900; name = "Hand of the red captain"; desc = "A weapon of devestating potential looted from an experimental terran lab."; aiming_time_fire_threshold = 3; projectile_damage = 70; aiming_time = 3; w_class = 3},/obj/item/necromantic_stone,/turf/open/floor/carpet/red,/area/shuttle/pirate)
"Hr" = (/obj/item/stack/sheet/mineral/wood/fifty,/obj/effect/mob_spawn/ghost_role/human/pirate/skeleton,/turf/open/floor/wood,/area/shuttle/pirate)
"Hy" = (/obj/structure/closet/cabinet{name = "The red captains cabinet"},/obj/item/clothing/shoes/pirate/armored,/obj/item/clothing/under/syndicate/bloodred{name = "blood-red suit"},/obj/item/clothing/suit/hooded/berserker{pressure_resistance = 10; min_cold_protection_temperature = 0; name = "Red captains armor"; desc = "Voices of the lost echo from the armor, looted and passed down through millenia of combat"; resistance_flags = 3},/obj/item/tank/jetpack/oxygen/security{name = "red captains jetpack"; desc = "A tank of compressed oxygen fitted for the red captain"},/obj/item/bedsheet/hos{name = "Red captains cloak"},/obj/item/card/id/advanced/black{trim = /datum/id_trim/pirate/captain; name = "The red captain"},/obj/item/radio/headset/syndicate/alt/leader{name = "red captains headset"},/obj/item/implanter/storage,/turf/open/floor/stone,/area/shuttle/pirate)
"Iy" = (/obj/structure/railing{color = "#4C3117"; dir = 4; name = "wooden railing"},/obj/structure/railing{color = "#4C3117"; dir = 8; name = "wooden railing"},/turf/open/floor/wood/airless,/area/shuttle/pirate)
"JC" = (/obj/structure/table,/obj/machinery/light/small/directional/west,/obj/item/reagent_containers/cup/glass/bottle/whiskey{pixel_y = 8},/obj/item/reagent_containers/cup/glass{pixel_y = 8; pixel_x = -7},/obj/item/reagent_containers/cup/glass{pixel_y = 7; pixel_x = 8},/turf/open/floor/carpet/royalblack/airless,/area/shuttle/pirate)
"Kw" = (/obj/effect/mob_spawn/corpse/human,/turf/open/floor/carpet/red,/area/shuttle/pirate)
"KD" = (/obj/effect/decal/cleanable/blood,/turf/open/floor/stone,/area/shuttle/pirate)
"KJ" = (/obj/structure/closet/crate/coffin{pixel_y = 6; name = "The red captains coffin"},/obj/item/flashlight/flare/candle/infinite{pixel_x = -10; pixel_y = -9},/obj/item/flashlight/flare/candle/infinite{pixel_x = 14; pixel_y = -8},/obj/item/flashlight/flare/candle/infinite{pixel_x = -12; pixel_y = 15},/obj/item/flashlight/flare/candle/infinite{pixel_x = 10; pixel_y = 17},/mob/living/carbon/human/species/vampire{real_name = "The Red Captain"; faction = list("pirate"); name = "The Red Captain"; use_random_name = 0; name_override = "The Red Captain"},/turf/open/floor/carpet/red,/area/shuttle/pirate)
"KP" = (/obj/structure/railing{color = "#4C3117"; dir = 8; name = "wooden railing"},/obj/structure/railing/corner{color = "#4C3117"; dir = 4; name = "wooden railing"},/turf/open/floor/wood/airless,/area/shuttle/pirate)
"Lm" = (/obj/structure/railing{dir = 6},/obj/effect/turf_decal/siding/wood/end{dir = 4},/obj/structure/cannon{dir = 4},/turf/open/floor/plating/airless,/area/shuttle/pirate)
"Lw" = (/obj/effect/turf_decal/siding/wood{dir = 1},/obj/effect/turf_decal/siding/wood/corner{dir = 8},/turf/open/floor/wood/airless,/area/shuttle/pirate)
"LI" = (/obj/structure/chair/comfy/shuttle{dir = 1},/turf/open/floor/wood/airless,/area/shuttle/pirate)
"LS" = (/obj/machinery/light/small/directional/west,/turf/open/floor/wood/airless,/area/shuttle/pirate)
"MR" = (/obj/effect/turf_decal/siding/wood/end,/turf/closed/wall/mineral/wood/nonmetal,/area/shuttle/pirate)
"NA" = (/obj/machinery/door/airlock/vault{color = "#825427"; name = "Ye Olde Strong Door"},/obj/effect/mapping_helpers/airlock/cutaiwire,/obj/structure/fans/tiny/invisible,/turf/open/floor/wood/airless,/area/shuttle/pirate)
"NO" = (/obj/structure/rack{icon = 'icons/obj/stationobjs.dmi'; icon_state = "minibar"; name = "skeletal minibar"},/obj/item/reagent_containers/condiment/milk{pixel_x = -5},/obj/item/reagent_containers/condiment/milk{pixel_x = 5},/obj/effect/turf_decal/siding/wood/corner{dir = 1},/turf/open/floor/carpet/red/airless,/area/shuttle/pirate)
"Of" = (/obj/effect/turf_decal/siding/wood/end{dir = 8},/turf/open/floor/wood/airless,/area/shuttle/pirate)
"OE" = (/obj/item/flashlight/flare/candle/infinite{pixel_x = 14; pixel_y = -8},/turf/open/floor/stone,/area/shuttle/pirate)
"OP" = (/obj/item/kirbyplants/random/dead,/obj/machinery/light/small/directional/south,/turf/open/floor/stone,/area/shuttle/pirate)
"OX" = (/obj/effect/turf_decal/siding/wood/corner,/turf/open/floor/wood/airless,/area/shuttle/pirate)
"Py" = (/obj/structure/rack{icon = 'icons/obj/stationobjs.dmi'; icon_state = "minibar"; name = "skeletal minibar"},/obj/item/reagent_containers/condiment/milk{pixel_x = -5},/obj/item/reagent_containers/condiment/milk{pixel_x = 5},/obj/effect/turf_decal/siding/wood/corner{dir = 8},/turf/open/floor/carpet/red/airless,/area/shuttle/pirate)
"Pz" = (/mob/living/basic/cow,/turf/open/floor/grass,/area/shuttle/pirate)
"PE" = (/obj/effect/turf_decal/siding/wood/corner{dir = 8},/turf/open/floor/carpet/red/airless,/area/shuttle/pirate)
"PF" = (/obj/machinery/porta_turret/syndicate/energy{faction = list("pirate")},/turf/closed/wall/mineral/wood/nonmetal,/area/shuttle/pirate)
"PZ" = (/turf/open/space/basic,/area/template_noop)
"Qj" = (/obj/effect/turf_decal/siding/wood/corner{dir = 1},/turf/open/floor/carpet/red/airless,/area/shuttle/pirate)
"Ql" = (/obj/effect/turf_decal/siding/wood/corner{dir = 4},/turf/open/floor/carpet/red/airless,/area/shuttle/pirate)
"Qm" = (/obj/structure/fermenting_barrel/gunpowder,/obj/item/reagent_containers/cup/bucket/wooden,/obj/item/reagent_containers/cup/bucket/wooden,/obj/effect/turf_decal/siding/wood,/turf/open/floor/wood/airless,/area/shuttle/pirate)
"QG" = (/obj/structure/table/wood/fancy/black,/obj/item/vorpalscythe{name = "Headtaker"; force = 20; bonus_force_multiplier = 5; block_chance = 10; wound_bonus = 20; bare_wound_bonus = 25; desc = "The legendary scythe wielded by the red captain, decapitating foes with this weapon makes it significantly stronger"; w_class = 3},/turf/open/floor/carpet/red,/area/shuttle/pirate)
"Rk" = (/obj/structure/fermenting_barrel/gunpowder,/obj/item/reagent_containers/cup/bucket/wooden,/obj/item/reagent_containers/cup/bucket/wooden,/obj/effect/turf_decal/siding/wood{dir = 1},/turf/open/floor/wood/airless,/area/shuttle/pirate)
"Ru" = (/obj/structure/rack,/obj/item/gun/energy/laser,/obj/item/gun/energy/laser{pixel_x = -3; pixel_y = 6},/obj/item/gun/energy/laser{pixel_y = 3},/obj/item/gun/energy/laser{pixel_y = 3},/obj/item/gun/energy/laser{pixel_y = 3},/obj/item/gun/energy/laser{pixel_y = 3},/obj/item/gun/energy/laser{pixel_y = 3},/obj/machinery/light/small/directional/north,/obj/effect/turf_decal/siding/wood{dir = 1},/turf/open/floor/wood,/area/shuttle/pirate)
"RO" = (/obj/structure/rack,/obj/item/gun/energy/laser{pixel_y = 3},/obj/item/gun/energy/laser{pixel_x = -3; pixel_y = 6},/obj/item/gun/energy/laser,/obj/item/gun/energy/laser{pixel_y = 3},/obj/item/gun/energy/laser{pixel_y = 3},/obj/item/gun/energy/laser{pixel_y = 3},/obj/item/gun/energy/laser{pixel_y = 3},/obj/machinery/light/small/directional/north,/obj/effect/turf_decal/siding/wood{dir = 1},/turf/open/floor/wood,/area/shuttle/pirate)
"RS" = (/obj/item/stack/cannonball/shellball/fourteen,/obj/effect/turf_decal/siding/wood{dir = 9},/turf/open/floor/wood,/area/shuttle/pirate)
"Sr" = (/obj/structure/rack,/obj/item/gun/ballistic/shotgun/automatic/combat,/obj/item/gun/ballistic/shotgun/automatic/combat,/obj/item/storage/box/lethalshot,/obj/item/storage/box/lethalshot,/obj/effect/turf_decal/siding/wood{dir = 4},/turf/open/floor/wood,/area/shuttle/pirate)
"Tq" = (/obj/machinery/porta_turret/syndicate/energy{dir = 1; faction = list("pirate")},/turf/closed/wall/mineral/wood/nonmetal,/area/shuttle/pirate)
"Ty" = (/obj/machinery/turretid{icon_state = "control_kill"; lethal = 1; locked = 0; pixel_y = -24; req_access = null},/turf/open/floor/wood/airless,/area/shuttle/pirate)
"TE" = (/obj/structure/window/reinforced/shuttle/survival_pod,/obj/docking_port/mobile/pirate{dir = 4},/turf/open/floor/wood/airless,/area/shuttle/pirate)
"TP" = (/obj/effect/turf_decal/siding/wood,/turf/open/floor/wood/airless,/area/shuttle/pirate)
"Ut" = (/obj/machinery/light/small/directional/south,/obj/effect/turf_decal/siding/wood{dir = 6},/turf/open/floor/wood/airless,/area/shuttle/pirate)
"Uy" = (/obj/structure/fermenting_barrel/gunpowder,/obj/item/reagent_containers/cup/bucket/wooden,/obj/item/reagent_containers/cup/bucket/wooden,/obj/machinery/light/small/directional/east,/turf/open/floor/wood/airless,/area/shuttle/pirate)
"Uz" = (/obj/effect/turf_decal/siding/wood/corner{dir = 4},/turf/open/floor/wood,/area/shuttle/pirate)
"UF" = (/turf/open/floor/stone,/area/shuttle/pirate)
"UJ" = (/obj/machinery/computer/piratepad_control{dir = 8},/turf/open/floor/carpet/royalblack/airless,/area/shuttle/pirate)
"UO" = (/obj/machinery/light/small/directional/north,/obj/effect/turf_decal/siding/wood{dir = 1},/turf/open/floor/wood/airless,/area/shuttle/pirate)
"UP" = (/obj/effect/decal/cleanable/blood,/obj/item/kirbyplants/random/dead,/obj/machinery/light/small/directional/south,/turf/open/floor/stone,/area/shuttle/pirate)
"UW" = (/obj/effect/turf_decal/siding/wood{dir = 8},/obj/machinery/light/small/directional/west,/turf/open/floor/carpet/red/airless,/area/shuttle/pirate)
"Vm" = (/obj/structure/railing{dir = 5},/obj/effect/turf_decal/siding/wood/end{dir = 4},/obj/structure/cannon{dir = 4},/turf/open/floor/plating/airless,/area/shuttle/pirate)
"VA" = (/obj/structure/festivus{anchored = 1; color = "#825427"; desc = "A sturdy pole designed to hold the vessel's solar sails in place."; name = "mast"; pixel_x = -16; pixel_y = 2},/turf/closed/wall/mineral/wood/nonmetal,/area/shuttle/pirate)
"VR" = (/obj/structure/railing{color = "#4C3117"; dir = 8; name = "wooden railing"},/obj/structure/railing{color = "#4C3117"; dir = 8; name = "wooden railing"},/obj/structure/railing{color = "#4C3117"; dir = 4; name = "wooden railing"},/turf/open/floor/wood/airless,/area/shuttle/pirate)
"VT" = (/obj/machinery/light/small/directional/west,/obj/effect/turf_decal/siding/wood{dir = 8},/turf/open/floor/wood/airless,/area/shuttle/pirate)
"Wl" = (/obj/structure/table/wood,/obj/machinery/recharger{pixel_y = 2},/obj/effect/turf_decal/siding/wood{dir = 1},/turf/open/floor/wood/airless,/area/shuttle/pirate)
"Wv" = (/obj/machinery/piratepad,/turf/open/floor/carpet/royalblack/airless,/area/shuttle/pirate)
"WB" = (/obj/structure/rack{icon = 'icons/obj/stationobjs.dmi'; icon_state = "minibar"; name = "skeletal minibar"},/obj/item/reagent_containers/condiment/milk{pixel_x = -5},/obj/item/reagent_containers/condiment/milk{pixel_x = 5},/obj/effect/turf_decal/siding/wood{dir = 1},/turf/open/floor/wood,/area/shuttle/pirate)
"WG" = (/obj/item/stack/cannonball/fourteen,/obj/structure/table/wood,/obj/item/flashlight/flare/torch,/turf/open/floor/wood/airless,/area/shuttle/pirate)
"WP" = (/obj/effect/mob_spawn/corpse/human,/turf/open/floor/stone,/area/shuttle/pirate)
"Xr" = (/obj/effect/turf_decal/siding/wood{dir = 6},/turf/open/floor/wood/airless,/area/shuttle/pirate)
"Xv" = (/obj/machinery/computer/shuttle/pirate,/turf/open/floor/carpet/royalblack/airless,/area/shuttle/pirate)
"XI" = (/obj/structure/lattice/catwalk,/turf/closed/wall/mineral/wood/nonmetal,/area/shuttle/pirate)
"Yx" = (/obj/item/stack/sheet/mineral/wood/fifty,/turf/open/floor/wood,/area/shuttle/pirate)
"Zx" = (/obj/machinery/light/small/directional/north,/obj/effect/turf_decal/siding/wood{dir = 5},/turf/open/floor/wood/airless,/area/shuttle/pirate)
"ZZ" = (/obj/machinery/computer/camera_advanced/shuttle_docker/syndicate/pirate,/turf/open/floor/carpet/royalblack/airless,/area/shuttle/pirate)

(1,1,1) = {"
PZPZPZPZPZPZPZPZPZPZPZPZPZPZPZPZkUPZPZPZPZPZPZPZPZPZPZPZPZPZPZPZkUPZPZPZPZPZPZPZPZPZPZPZPZPZPZPZPZPZPZPZPZ
PZPZPZPZPZPZPZPZPZPZPZPZPZPZPZkUmCkUPZPZPZPZPZPZPZPZPZPZPZPZPZkUmCkUPZPZPZPZPZPZPZPZPZPZPZPZPZPZPZPZPZPZPZ
PZPZPZPZPZPZPZPZPZPZPZPZPZPZPZkUmCkUPZPZPZPZPZPZPZPZPZPZPZPZPZkUmCkUPZPZPZPZPZPZPZPZPZPZPZPZPZPZPZPZPZPZPZ
PZPZPZPZPZPZPZPZPZPZPZPZPZPZPZkUmCkUkUPZPZPZPZPZPZPZPZPZPZPZPZkUmCkUkUPZPZPZPZPZPZPZPZPZPZPZPZPZPZPZPZPZPZ
PZPZPZPZPZPZPZPZPZPZPZPZPZPZPZkUmCmCmCkUPZPZPZPZPZPZPZPZPZPZPZkUmCmCmCkUPZPZPZPZPZPZPZPZPZPZPZPZPZPZPZPZPZ
PZPZPZPZPZPZPZPZPZPZPZPZPZPZPZkUmCmCkUPZPZPZPZPZPZPZPZPZPZPZPZkUmCmCkUPZPZPZPZPZPZPZPZPZPZPZPZPZPZPZPZPZPZ
PZPZPZPZPZPZPZPZPZPZPZPZPZPZPZkUmCkUPZPZPZPZPZPZPZPZPZPZPZPZPZkUmCkUPZPZPZPZPZPZPZPZPZPZPZPZPZPZPZPZPZPZPZ
PZPZPZPZxmTqxmxmPZPZPZPZPZPZPZkUmCkUPZPZPZdQPZPZPZPZPZPZPZPZPZkUmCkUPZPZPZPZPZPZPZPZPZPZPZPZPZPZPZPZPZPZPZ
PZPZPZxmxmxmxmxmxmPZPZPZPZPZmCmCmCkUPZPZPZIyPZPZPZPZPZPZPZPZFamCmCkUPZPZPZPZPZPZPZPZPZPZPZPZPZPZPZPZPZPZPZ
PZPZTqxmRSRORuCJxmxmTqvswjxmibrnXIibwjxmibIyxmibwjxmibwjxmibrnxmibwjxmibwjMRibwjxmxmxmPZPZPZPZPZPZPZPZPZPZ
PZPZxmdRxTYxHrUzcPwTxmOfLwWlAvdQesAvAvwVAvdQesAvAvWlAvAvesAvdQwVAvAvesAvAvWlAvAvZxxmwjwjPZPZPZPZPZPZPZPZPZ
PZxmxmscqPhrhrqPqPSrxmxmVTWGdQdQdQdQdQWGdQdQdQdQdQWGdQdQdQdQdQWGdQdQdQdQdQWGdQdQbXhIwjwjxmPZPZPZPZPZPZPZPZ
PZxmsMvZeEoveEeEqPajrmxmqflRdQdQdQdQdQdQdQdQdQdQdQdQdQdQdQdQdQlRdQdQdQdQdQdQdQdQdQdQAvhIxmvxxmPZPZPZPZPZPZ
soxmxmxmxmxmxmxmdhxmxmxmqfdQdQkRxmhxkRxmdQdQdQdQxmwjwjwjxmdQdQdQdQdQdQxmxmmYxmxmdQdQdQbXUOhIxmwjxmPZPZPZPZ
xmwBjAtzWBfJgTfJqPfJALxmfiBaPyxmyldQylxmoqBaPEdQxmJCXvZZwjdQdQoqBaPEbPxmyldQylxmdQoqBaPEdQbXRkunxmxmwjxmPZ
xmPzjAdtqPqPqPqPCSqPqPNAntVAUWxmitdQylxmlpVAwddQeddQLIwMTEdQdQpEVAUWdQxmyldQUyxmLSntVAekdQdQdQbXAvUOAvAvVm
xmPzjAdtCSqPCSqPqPqPqPNAntVAUWxmyldQUyxmntVAekdQedTydQzlwjdQdQpEVAUWdQxmitdQylxmdQntVAekdQdQdQOXTPAHTPTPLm
xmwBjAdtmbqPqPjeqPqPqYxmejfFNOxmyldQylxmQlfFQjdQxmAWWvUJwjdQdQQlfFQjbPxmyldQylxmdQQlfFQjdQOXQmEExmxmwjxmPZ
soxmwtwtwtuBttwtwtwtwtxmqflRdQxmxmmYxmxmdQdQdQdQxmwjwjwjxmdQdQdQdQdQdQxmxmmYxmxmdQdQdQiDAHXrxmwjxmPZPZPZPZ
PZxmausuxGwrfExGUFsuauxmqfdQdQdQdQdQdQdQdQdQlRdQdQdQdQdQdQdQdQdQdQdQdQdQdQdQdQdQdQOXTPXrxmxkxmPZPZPZPZPZPZ
PZxmxmKDWPopfEwrKJOExmxmVTWGdQdQdQdQdQWGdQdQdQdQdQWGlRdQdQdQdQWGdQdQdQdQdQWGdQdQOXXrwjwjxmPZPZPZPZPZPZPZPZ
PZPZxmsukBwrKwkBUPHyxmOfxHkdTPTPjcTPTPFGTPdQjcTPTPkdTPdQjcTPTPFGTPTPjcdQdQkdTPTPUtxmwjwjPZPZPZPZPZPZPZPZPZ
PZPZPFxmOPFQQGsuxmxmPFrfwjxmxkwjxmxkwjxmxkIyxmxkwjxmxkrnxmxkwjxmxkwjxmxkIyxmxkwjxmxmxmPZPZPZPZPZPZPZPZPZPZ
PZPZPZxmxmxmxmxmxmPZPZPZPZPZmCmCmCkUPZPZPZIyPZPZPZPZPZVRPZPZmCmCmCkUPZPZKPeBPZPZPZPZPZPZPZPZPZPZPZPZPZPZPZ
PZPZPZPZxmPFxmxmPZPZPZPZPZPZPZkUmCkUPZPZPZdQPZPZPZPZPZdQPZPZPZkUmCkUPZPZPZdQPZPZPZPZPZPZPZPZPZPZPZPZPZPZPZ
PZPZPZPZPZPZPZPZPZPZPZPZPZPZPZkUmCkUPZPZPZPZPZPZPZPZPZPZPZPZPZkUmCkUPZPZPZPZPZPZPZPZPZPZPZPZPZPZPZPZPZPZPZ
PZPZPZPZPZPZPZPZPZPZPZPZPZPZPZkUmCkUPZPZPZPZPZPZPZPZPZPZPZPZPZkUmCkUPZPZPZPZPZPZPZPZPZPZPZPZPZPZPZPZPZPZPZ
PZPZPZPZPZPZPZPZPZPZPZPZPZPZPZkUmCmCkUPZPZPZPZPZPZPZPZPZPZPZPZkUmCmCkUPZPZPZPZPZPZPZPZPZPZPZPZPZPZPZPZPZPZ
PZPZPZPZPZPZPZPZPZPZPZPZPZPZPZkUmCmCmCkUPZPZPZPZPZPZPZPZPZPZPZkUmCmCmCkUPZPZPZPZPZPZPZPZPZPZPZPZPZPZPZPZPZ
PZPZPZPZPZPZPZPZPZPZPZPZPZPZPZkUmCkUkUPZPZPZPZPZPZPZPZPZPZPZPZkUmCkUkUPZPZPZPZPZPZPZPZPZPZPZPZPZPZPZPZPZPZ
PZPZPZPZPZPZPZPZPZPZPZPZPZPZPZkUmCkUPZPZPZPZPZPZPZPZPZPZPZPZPZkUmCkUPZPZPZPZPZPZPZPZPZPZPZPZPZPZPZPZPZPZPZ
PZPZPZPZPZPZPZPZPZPZPZPZPZPZPZPZkUPZPZPZPZPZPZPZPZPZPZPZPZPZPZPZquPZPZPZPZPZPZPZPZPZPZPZPZPZPZPZPZPZPZPZPZ
"}
